03 03 03 03 03 03 03 01 01 01 01 01 01 01 01 01 01 01 01 01 01 01 01 01 01 
03 03 03 03 03 03 01 01 01 01 01 01 01 01 01 01 01 01 01 08 08 08 18 01 01 
03 03 03 03 03 03 01 01 08 08 08 08 08 08 08 08 08 08 08 08 08 08 08 08 01 
03 03 03 03 03 01 01 01 08 08 08 08 08 08 08 08 01 08 15 08 08 08 08 08 01 
03 03 03 03 03 01 01 01 01 01 01 01 08 01 01 01 01 01 08 08 08 12 08 18 01 
03 03 03 03 01 01 01 01 01 01 01 08 08 01 01 01 01 01 01 08 08 08 08 08 01 
03 03 03 03 01 01 01 01 01 01 08 08 08 01 01 01 01 01 01 08 08 08 08 08 01 
03 03 03 01 01 01 01 01 01 08 08 08 08 08 01 01 01 01 01 08 08 08 08 08 01 
03 03 08 01 01 01 01 01 01 08 08 08 08 08 01 01 01 01 01 01 11 01 01 01 01 
03 03 08 01 01 01 01 01 01 01 01 01 08 01 01 01 01 01 01 08 08 01 01 01 01 
03 08 08 01 01 01 01 01 01 01 01 01 08 01 01 01 01 01 08 08 08 01 01 08 01 
19 05 05 05 05 05 08 08 05 05 08 08 08 08 08 01 01 01 08 08 01 01 01 08 01 
03 08 08 01 01 01 08 08 08 05 05 08 08 08 08 08 01 01 08 08 01 08 08 08 19 
03 08 08 01 01 01 08 08 08 08 05 05 08 08 08 08 01 01 01 08 08 08 08 08 01 
03 08 08 01 01 08 08 08 08 08 08 24 05 08 01 08 08 08 08 08 05 08 01 08 01 
03 03 08 08 01 08 08 08 08 08 08 08 08 08 08 08 08 08 08 05 08 01 01 01 01 
03 03 03 08 01 08 08 08 08 08 08 08 08 08 08 05 08 05 08 08 08 01 01 01 03 
03 03 03 03 01 08 08 24 08 08 08 01 01 01 01 08 05 08 08 08 08 08 01 03 03 
14 03 03 03 01 01 08 08 08 01 01 01 01 08 08 05 08 08 08 08 08 01 01 03 03 
14 14 03 03 03 03 01 08 01 01 01 01 08 05 05 08 08 08 08 08 08 01 14 03 03 
14 14 14 14 14 03 01 01 01 01 01 08 08 05 01 08 08 08 08 08 08 14 14 14 03 
14 14 14 14 14 14 01 01 01 01 01 01 08 05 05 01 01 01 08 08 14 14 01 01 01 
14 14 14 14 14 14 14 14 01 01 01 01 14 14 05 05 14 14 01 08 14 14 01 01 01 
14 14 14 14 14 14 14 14 01 14 14 14 14 01 01 05 01 14 14 14 14 01 01 01 01 
14 14 14 14 14 14 14 14 14 14 01 01 01 01 01 20 01 01 01 01 01 01 01 01 01 
