03 03 03 03 03 02 02 02 02 02 02 02 02 02 02 02 02 02 02 02 02 02 03 03 03 
03 10 10 10 10 02 07 07 02 07 07 07 07 07 07 07 07 07 02 07 07 02 10 10 03 
03 10 10 10 10 02 07 07 02 07 07 07 07 07 07 07 07 07 02 07 07 02 10 10 03 
03 10 10 10 10 02 10 10 02 07 07 07 07 07 07 07 07 07 02 10 10 02 10 10 03 
03 10 10 10 10 02 10 02 02 06 06 06 06 06 06 06 06 06 02 02 10 02 10 10 03 
03 10 10 10 10 02 10 02 06 06 06 06 06 06 06 06 06 06 06 02 10 02 10 10 03 
03 10 10 10 10 02 10 02 06 06 06 06 06 06 06 06 06 06 06 02 10 02 10 10 03 
03 10 10 10 10 02 10 02 06 06 07 07 06 06 06 07 07 06 06 02 10 02 10 10 03 
03 10 10 10 10 02 10 02 06 06 07 07 06 06 06 07 07 06 06 02 10 02 10 10 03 
03 10 10 10 10 02 10 02 06 06 07 07 06 18 06 07 07 06 06 02 10 02 10 10 03 
03 10 10 10 10 02 10 02 06 06 07 07 06 06 06 07 07 06 06 02 10 02 10 10 03 
03 10 10 10 10 02 10 02 06 06 07 07 06 06 06 07 07 06 06 02 10 02 10 10 03 
03 10 10 10 10 02 10 02 06 06 07 07 06 06 06 07 07 06 06 02 10 02 10 10 03 
03 10 10 10 10 02 10 02 06 06 06 06 06 06 06 06 06 06 06 02 10 02 10 10 03 
03 10 10 10 10 02 10 02 06 06 06 06 06 06 06 06 06 06 06 02 10 02 10 10 03 
03 10 10 10 10 02 10 02 02 02 02 02 02 10 02 02 02 02 02 02 10 02 10 10 03 
03 10 10 10 10 02 10 10 10 10 10 10 10 10 10 10 10 10 10 10 10 02 10 10 03 
03 10 10 10 02 02 10 02 10 10 10 10 10 10 10 10 10 10 10 02 10 02 02 10 03 
03 10 10 10 02 07 07 02 02 02 02 02 10 10 10 02 02 02 02 02 07 07 02 10 03 
03 10 10 10 02 07 07 02 10 10 10 02 10 10 10 02 10 10 10 02 07 07 02 10 03 
03 10 10 10 10 02 02 10 10 10 10 02 02 10 02 02 10 10 10 10 02 02 10 10 03 
03 10 10 10 10 10 10 10 10 10 10 10 10 10 10 10 10 10 10 10 10 10 10 10 03 
03 10 10 10 10 10 10 10 10 10 10 10 10 10 10 10 10 10 10 10 10 10 10 10 03 
03 10 10 10 10 10 10 10 10 10 10 10 10 10 10 10 10 10 10 10 10 10 10 10 03 
03 03 03 03 03 03 03 03 03 03 03 03 03 20 03 03 03 03 03 03 03 03 03 03 03 
