01 01 01 01 01 01 01 01 01 01 01 01 01 01 01 01 01 01 01 01 01 01 01 01 01 
01 01 01 01 01 01 01 08 08 08 08 01 01 01 01 01 01 01 01 01 01 01 01 01 01 
01 01 01 01 01 01 01 08 08 08 08 08 01 01 01 01 01 01 01 01 01 01 01 01 01 
01 01 01 08 08 08 08 08 01 01 01 08 08 01 01 01 01 01 01 01 01 01 01 01 01 
01 01 08 08 01 01 01 01 01 01 01 01 08 08 01 01 08 08 08 01 01 01 01 01 01 
01 01 08 08 01 01 01 01 01 01 01 01 08 08 08 08 08 08 08 08 01 01 01 01 01 
01 01 08 08 01 01 01 08 01 01 01 08 08 08 08 08 08 01 01 01 08 01 01 01 01 
01 01 01 08 08 01 08 08 08 08 08 08 08 14 14 08 08 01 01 01 01 08 01 01 01 
01 01 01 01 08 08 08 08 08 08 14 14 14 14 08 08 08 01 01 01 01 01 08 01 01 
01 01 01 08 08 08 08 08 08 08 24 14 14 14 14 08 08 01 01 01 01 01 08 01 01 
01 01 08 08 01 08 08 08 08 08 08 14 14 14 14 08 01 01 08 01 01 01 08 01 01 
01 01 08 01 01 08 08 08 08 08 08 05 14 14 08 08 08 08 08 08 01 01 08 01 01 
19 05 08 08 08 08 08 08 08 08 08 05 08 08 08 08 08 08 08 08 08 08 05 08 19 
01 08 08 05 05 08 08 08 08 08 05 08 08 08 08 08 01 08 08 08 08 08 08 01 01 
01 08 08 08 08 05 05 08 05 08 08 08 05 08 08 08 01 01 01 08 08 05 08 01 01 
01 01 08 08 08 08 08 08 08 08 08 08 08 05 08 08 01 01 01 08 08 05 08 01 01 
03 03 08 08 08 08 08 08 08 01 08 08 08 08 08 08 01 01 01 01 08 08 08 08 01 
03 03 03 08 08 08 08 08 01 01 01 01 08 08 05 08 08 01 01 08 08 08 08 08 01 
03 03 03 03 08 08 08 01 01 01 01 01 01 08 08 08 08 01 01 08 08 08 08 01 01 
03 03 03 03 01 01 01 01 01 01 01 01 01 08 08 08 08 08 08 08 08 05 08 01 01 
03 03 03 03 01 01 01 01 01 01 01 01 01 08 08 05 08 08 08 08 08 08 08 01 01 
01 03 03 01 01 01 01 01 01 01 01 01 01 01 08 08 05 08 08 08 05 08 08 01 01 
01 03 03 01 01 01 01 01 01 01 01 01 01 01 08 08 08 08 05 05 08 08 01 01 01 
01 01 01 01 01 01 01 01 01 01 01 01 01 01 01 08 08 08 08 08 08 01 01 01 01 
01 01 01 01 01 01 01 01 01 01 01 01 01 01 01 01 01 01 01 01 01 01 01 01 01 
