01 01 01 01 01 01 01 01 01 01 01 01 01 01 01 01 01 01 01 01 01 01 01 01 01 
01 01 01 01 08 08 01 01 01 01 01 11 08 08 01 01 01 01 01 01 01 01 01 01 01 
01 01 01 08 08 08 08 01 01 01 08 08 08 08 08 08 08 08 08 01 01 01 01 01 01 
01 01 01 08 08 08 08 08 11 08 08 23 08 08 11 08 08 08 08 08 01 01 01 01 01 
01 01 01 01 08 08 08 08 08 08 08 08 08 08 08 08 08 08 08 08 01 01 01 01 01 
01 01 01 08 08 08 08 08 23 08 23 08 23 08 23 08 08 08 08 08 01 01 01 01 01 
01 01 01 08 08 08 08 08 08 08 08 08 08 08 08 08 08 08 08 01 01 01 01 01 01 
01 01 08 08 08 08 11 08 08 23 08 24 08 23 08 08 11 08 08 01 01 01 01 01 01 
01 08 08 08 08 08 08 08 08 08 08 08 08 08 08 08 08 08 01 01 01 01 01 01 01 
01 08 08 08 08 08 08 08 23 08 23 08 23 08 23 08 08 08 01 01 01 01 01 01 01 
01 01 08 08 08 08 08 08 08 08 08 08 08 08 08 08 08 08 08 01 01 01 01 01 01 
01 01 01 08 08 08 08 08 11 08 08 23 08 08 11 08 08 08 08 08 01 01 01 01 01 
01 01 01 01 01 08 08 08 08 08 08 08 08 08 08 08 08 08 08 08 08 08 01 01 01 
01 01 01 01 01 01 08 08 08 08 08 11 08 08 08 08 08 08 08 08 08 08 08 01 01 
01 01 01 01 01 01 08 08 08 08 08 08 08 08 08 08 08 08 08 08 08 08 08 01 01 
01 01 01 01 01 01 01 08 08 01 08 08 08 08 08 08 08 08 08 08 08 08 08 08 01 
01 01 01 01 01 08 08 08 01 01 01 08 08 08 08 08 08 08 08 08 08 08 08 08 01 
01 01 01 01 08 08 08 08 08 01 01 01 08 08 08 08 08 08 08 15 08 08 08 08 01 
01 01 01 08 08 08 08 08 08 08 08 08 08 08 08 08 08 08 08 08 08 08 08 08 01 
01 01 08 08 08 08 08 08 08 08 08 08 08 08 08 08 08 08 08 08 08 08 08 08 01 
19 08 08 08 08 01 01 08 08 08 08 08 08 08 08 08 08 08 08 08 08 08 08 01 01 
01 01 08 08 01 01 01 01 01 08 08 08 08 08 08 08 08 08 08 08 08 08 01 01 01 
01 01 01 01 01 01 01 01 01 01 08 08 08 01 01 01 08 08 08 08 08 08 01 01 01 
01 01 01 01 01 01 01 01 01 01 01 01 01 01 01 01 01 08 08 08 01 01 01 01 01 
01 01 01 01 01 01 01 01 01 01 01 01 01 01 01 01 01 01 01 01 01 01 01 01 01 
