03 03 03 03 03 03 03 03 03 03 03 03 03 03 03 03 03 03 03 03 03 03 03 03 03 
03 10 10 10 10 10 10 10 10 10 10 10 10 10 10 10 10 10 10 10 10 10 10 10 03 
03 10 10 10 10 10 10 10 10 10 10 10 10 10 10 10 10 10 10 10 10 10 10 10 03 
03 10 10 10 02 02 02 02 02 02 02 10 10 10 04 10 10 10 10 10 10 10 10 10 03 
03 10 10 10 02 01 10 10 10 10 02 10 10 11 04 10 10 10 10 10 10 10 10 10 03 
03 10 10 10 02 10 01 10 10 10 02 10 10 10 10 10 10 10 10 11 10 10 10 10 03 
03 10 10 10 02 10 01 01 10 10 02 10 10 10 04 10 10 10 01 24 10 01 10 10 03 
03 10 10 10 02 01 01 01 10 10 10 10 10 10 10 10 10 10 01 01 01 01 01 10 03 
03 10 10 10 02 02 02 02 02 02 10 04 10 10 10 10 10 10 10 01 01 01 10 10 03 
03 10 10 10 10 10 10 10 11 10 10 10 10 10 10 10 10 10 10 10 01 10 10 10 03 
03 10 10 10 10 10 10 10 10 10 10 10 10 10 10 10 10 10 10 10 10 10 10 10 03 
03 10 10 10 10 10 10 10 10 10 10 10 10 10 10 04 10 10 10 04 10 10 10 04 03 
03 04 10 11 10 10 10 10 10 10 10 10 10 10 10 10 04 04 10 04 04 04 04 10 03 
19 10 10 10 10 10 10 10 10 10 10 10 10 10 10 10 10 10 11 10 10 10 10 10 19 
03 10 10 10 10 10 10 10 10 11 10 10 10 10 10 10 10 10 10 10 04 01 10 10 03 
03 10 10 10 10 10 10 10 10 04 10 10 10 10 10 10 10 10 10 01 01 01 01 10 03 
03 10 10 10 10 01 01 01 04 10 10 10 06 06 06 18 06 10 10 10 01 01 10 10 03 
03 10 10 10 10 01 13 01 04 10 10 10 24 06 06 06 06 10 10 10 01 10 10 10 03 
03 10 10 10 10 01 01 01 10 04 11 10 06 06 12 06 06 10 10 10 10 10 10 10 03 
03 10 10 10 10 10 01 10 10 04 04 10 06 23 06 06 06 10 10 10 10 11 10 10 03 
03 10 10 10 10 10 10 09 09 10 04 10 06 06 06 06 06 10 10 10 10 10 10 10 03 
03 10 10 10 10 10 11 09 09 09 10 04 04 10 10 10 10 10 10 10 10 10 10 10 03 
03 10 10 10 10 10 09 14 14 09 09 04 04 10 10 10 10 10 10 10 10 10 10 10 03 
03 10 10 10 10 09 14 14 14 14 09 09 04 04 10 10 10 10 10 10 10 10 10 10 03 
03 03 03 03 03 14 14 14 14 14 14 14 03 03 03 03 03 03 03 03 03 03 03 03 03 
