01 01 01 01 01 01 01 01 01 01 01 01 01 01 01 01 01 01 01 01 01 01 01 01 01 
01 01 01 01 01 01 01 01 01 01 01 01 01 15 01 01 01 01 01 01 01 01 01 01 01 
01 01 01 01 01 01 01 01 01 01 01 01 08 08 08 01 01 01 01 01 01 01 01 01 01 
01 01 01 01 01 01 01 01 01 01 01 01 08 08 08 08 01 01 01 01 01 01 01 01 01 
01 01 01 01 01 01 01 01 01 01 01 01 01 08 08 08 08 01 01 01 01 01 01 01 01 
01 01 01 01 01 01 01 01 13 13 01 01 01 01 08 08 08 08 01 01 01 01 01 01 01 
01 01 01 01 01 01 01 13 13 13 13 01 01 01 08 08 08 08 01 01 01 01 01 01 01 
01 01 01 01 01 01 01 13 13 13 13 13 01 01 08 08 08 08 01 01 01 01 01 01 01 
01 01 01 01 01 01 01 01 13 13 13 13 01 01 08 08 08 01 01 01 01 01 01 01 01 
01 01 01 01 01 01 01 13 13 13 13 13 01 08 08 08 08 01 01 01 01 01 01 01 01 
01 01 08 08 08 13 13 13 13 13 13 13 08 08 08 08 01 01 01 01 01 01 01 01 01 
01 08 08 08 08 08 13 13 13 13 08 08 08 08 08 08 01 01 01 01 01 01 01 01 01 
19 05 08 08 08 08 08 08 13 08 08 08 08 08 08 08 01 01 01 01 01 01 01 01 01 
01 01 08 08 05 08 08 08 08 08 08 08 08 08 08 01 01 01 01 01 01 01 01 01 01 
01 01 01 08 08 05 08 08 08 08 01 08 08 01 01 01 01 01 01 01 01 01 01 01 01 
01 01 01 01 08 08 08 08 08 01 01 08 08 01 01 01 01 01 01 01 01 01 01 01 01 
01 01 01 08 08 08 08 08 08 08 08 08 08 08 01 01 01 01 01 01 01 01 01 01 01 
01 01 01 01 08 08 08 08 05 08 05 08 08 08 08 08 01 01 01 01 01 01 01 01 01 
01 01 01 01 08 08 08 08 08 08 08 08 08 08 08 08 08 08 08 01 01 01 01 01 01 
01 01 01 08 08 08 08 08 08 08 08 08 05 08 08 08 08 08 08 08 01 01 01 01 01 
01 01 08 08 08 08 08 08 08 08 08 08 08 08 08 01 08 08 08 08 01 01 01 01 01 
01 08 08 08 08 08 01 01 08 01 01 01 08 08 08 01 01 01 01 08 08 01 01 01 01 
01 01 08 08 08 01 01 01 01 01 01 01 01 01 08 08 08 01 01 08 08 01 01 01 01 
01 01 01 01 01 01 01 01 01 01 01 01 01 01 01 01 08 08 08 08 08 01 01 01 01 
01 01 01 01 01 01 01 01 01 01 01 01 01 01 01 01 01 01 20 01 01 01 01 01 01 
