01 01 01 01 01 01 01 01 01 01 01 01 01 01 01 01 01 01 20 01 01 01 01 01 01 
01 01 01 01 01 01 01 01 01 01 01 01 01 01 01 01 01 01 08 01 01 01 01 01 01 
01 01 01 01 01 01 01 01 01 01 01 01 08 08 08 08 08 08 08 08 01 01 01 01 01 
01 01 01 08 08 08 01 01 01 01 08 08 08 08 08 08 08 08 08 08 08 08 01 01 01 
01 01 08 08 08 08 08 01 01 08 08 08 08 08 08 08 08 08 08 08 08 08 01 01 01 
01 08 08 08 08 08 08 08 08 08 08 08 08 08 08 08 08 08 08 08 08 08 08 01 01 
01 08 08 08 08 08 08 08 08 08 08 08 08 08 08 08 08 08 08 08 08 08 08 01 01 
01 01 08 08 08 08 08 08 08 08 08 08 08 08 08 08 08 08 08 08 08 08 08 08 01 
01 01 01 08 08 08 08 08 08 08 06 06 06 06 06 08 08 08 08 08 08 08 08 08 01 
01 01 01 08 08 08 08 08 08 06 06 02 06 02 06 06 08 08 08 08 08 08 08 08 01 
01 01 08 08 08 08 08 08 06 06 02 07 07 07 02 06 06 08 08 08 08 08 08 01 01 
01 19 08 08 08 08 08 08 06 02 07 07 07 07 07 02 06 08 08 08 08 08 08 01 01 
01 01 01 08 08 08 08 08 06 06 07 07 12 07 07 06 06 08 08 08 08 08 01 01 01 
01 01 08 08 08 08 08 08 06 02 07 07 07 07 07 02 06 08 08 08 08 08 01 01 01 
01 08 08 08 08 08 08 08 06 06 02 07 07 07 02 06 06 08 08 08 08 08 01 01 01 
01 08 08 08 08 08 08 08 08 06 06 02 06 02 06 06 08 08 08 08 08 08 01 01 01 
01 08 08 08 08 08 08 08 08 08 06 06 06 06 06 08 08 08 08 08 08 01 01 01 01 
01 01 08 08 08 08 08 08 08 08 08 08 08 08 08 08 08 08 08 08 01 01 01 01 01 
01 01 01 08 08 08 08 08 08 08 08 08 08 08 08 08 08 08 01 01 01 01 01 01 01 
01 01 01 01 08 08 08 08 08 08 08 08 08 08 08 08 08 01 01 01 01 01 01 01 01 
01 01 01 01 01 08 08 08 08 08 08 08 08 08 08 01 01 01 01 01 01 01 01 01 01 
01 01 01 01 01 01 08 08 08 08 01 08 08 08 01 01 01 01 01 01 01 01 01 01 01 
01 01 01 01 01 01 01 08 08 01 01 01 08 08 01 01 01 01 01 01 01 01 01 01 01 
01 01 01 01 01 01 01 01 01 01 01 01 08 01 01 01 01 01 01 01 01 01 01 01 01 
01 01 01 01 01 01 01 01 01 01 01 01 20 01 01 01 01 01 01 01 01 01 01 01 01 
