01 01 01 01 01 01 01 01 01 01 01 01 20 01 01 01 01 01 01 01 01 01 01 01 01 
01 01 01 01 01 01 01 01 01 01 01 08 08 08 01 01 01 01 01 01 01 01 01 01 01 
01 01 01 01 01 01 01 01 01 08 08 08 08 08 01 01 01 01 01 01 01 01 01 01 01 
01 01 01 01 01 01 01 01 08 08 08 08 08 08 08 01 01 01 01 01 01 01 01 01 01 
01 01 01 01 01 01 01 08 08 08 08 08 08 08 08 08 01 01 01 01 01 01 01 01 01 
01 01 01 01 01 01 08 08 08 08 08 08 08 08 08 08 08 08 08 08 01 01 01 01 01 
01 01 01 01 01 01 08 08 08 08 08 08 08 08 08 08 08 08 08 08 08 08 01 01 01 
01 01 01 01 01 01 08 08 08 08 08 08 08 08 08 08 08 08 08 08 08 08 08 08 01 
01 01 01 01 01 01 01 08 08 08 08 08 08 08 08 08 08 08 08 08 08 08 08 08 19 
01 01 01 01 01 01 01 08 08 08 08 08 08 08 08 08 08 08 08 08 08 08 01 01 01 
01 01 01 01 01 01 01 01 08 08 08 08 08 08 08 08 08 08 08 08 08 01 01 01 01 
01 01 01 01 01 01 01 01 01 08 08 08 08 08 08 08 08 08 08 01 01 01 08 01 01 
01 01 01 01 01 01 01 01 01 01 08 08 08 08 08 08 08 08 01 01 08 08 03 08 08 
01 01 01 01 01 01 08 08 01 01 01 08 08 08 08 08 08 01 01 08 03 03 03 03 03 
01 01 01 01 01 08 08 08 08 01 01 01 01 08 08 01 01 01 01 08 03 03 03 03 03 
01 01 01 01 01 01 08 08 08 08 08 01 01 01 01 01 01 01 08 03 03 03 03 03 03 
01 01 01 01 01 01 01 08 08 08 08 08 01 01 01 01 01 01 01 08 03 03 03 03 03 
01 01 01 01 01 01 01 08 08 08 08 08 08 08 08 08 01 01 01 01 08 03 03 03 03 
01 01 01 01 01 01 01 08 08 08 08 08 08 08 08 08 08 01 01 01 01 08 03 03 08 
01 01 01 01 01 01 01 08 08 08 08 08 08 08 08 08 08 08 08 01 01 01 08 08 01 
01 01 01 01 01 01 08 08 08 08 01 01 01 08 08 08 08 08 08 08 01 01 01 01 01 
01 01 01 01 01 08 08 08 08 01 01 01 01 01 01 01 08 08 08 08 08 08 01 01 01 
01 01 01 01 08 08 08 08 01 01 01 01 01 01 01 01 01 08 08 08 08 08 08 08 01 
01 01 01 08 08 08 08 08 01 01 01 01 01 01 01 01 01 01 01 08 08 08 08 08 01 
01 01 01 08 08 08 08 08 01 01 01 01 01 01 01 01 01 01 01 01 08 08 08 08 08 
