03 03 03 03 03 03 03 03 03 03 03 03 03 03 03 03 03 03 01 01 01 01 03 03 03 
03 10 10 10 10 10 10 10 10 10 10 10 04 10 10 10 01 01 14 14 01 01 01 01 03 
03 10 10 10 10 10 10 10 10 10 10 01 01 10 10 10 01 14 14 14 14 08 15 01 03 
03 10 10 10 10 10 10 10 10 10 01 15 08 01 01 01 01 14 14 14 14 08 01 01 03 
03 10 10 10 10 10 10 10 10 10 01 08 08 08 08 01 08 14 14 14 08 08 08 01 03 
03 10 10 10 10 10 10 10 10 01 08 08 08 08 01 01 08 08 14 08 08 08 08 01 03 
03 10 10 10 10 10 10 10 10 01 08 08 08 08 08 01 08 08 08 08 08 08 01 01 03 
03 10 10 10 10 10 10 10 10 01 08 08 08 08 08 01 08 01 08 01 01 08 24 01 03 
03 10 10 10 10 10 10 10 10 10 01 08 08 01 08 08 08 08 01 01 10 01 01 10 03 
03 10 10 10 10 10 10 10 10 10 04 01 01 10 01 01 08 01 10 03 03 10 10 03 03 
03 10 10 02 10 10 02 10 04 10 10 04 10 10 01 01 08 01 10 10 03 03 03 03 03 
03 10 02 02 06 06 10 10 10 10 10 10 10 10 01 04 10 01 10 04 10 10 10 04 03 
19 04 02 18 06 06 02 10 10 04 10 04 10 04 10 10 04 04 10 04 04 04 04 04 03 
03 10 02 06 06 06 04 10 10 10 10 10 10 04 10 10 10 10 10 10 10 10 10 10 03 
03 10 10 10 02 10 04 10 04 10 10 04 10 10 04 10 10 10 03 10 04 03 10 10 03 
03 10 10 10 10 10 10 10 10 04 10 10 10 10 10 10 10 10 03 03 10 03 10 03 03 
03 10 03 03 10 10 10 04 04 10 10 10 10 10 10 10 10 10 10 10 03 10 03 10 03 
03 10 03 10 10 10 10 10 04 10 10 10 10 10 10 10 10 10 10 10 03 10 10 03 03 
03 10 10 10 10 03 03 10 10 04 10 10 10 10 10 10 10 10 03 10 10 10 03 03 03 
03 03 10 10 10 10 10 10 10 04 04 10 10 10 10 10 10 10 03 03 10 10 03 10 03 
03 03 03 10 03 10 10 10 10 10 04 10 10 10 10 10 10 10 10 10 10 03 10 10 03 
03 03 03 10 03 10 03 10 10 10 10 04 04 10 10 10 10 10 10 10 03 03 10 10 03 
03 03 10 10 03 10 03 10 10 10 10 04 04 10 10 10 10 10 03 03 03 10 10 03 03 
03 03 03 10 10 10 10 03 10 10 10 10 04 04 10 10 10 10 03 03 03 10 03 10 03 
03 03 03 03 03 03 03 03 03 03 03 03 20 03 03 03 03 03 03 03 03 03 03 03 03 
