03 03 03 03 03 03 03 03 03 03 03 03 20 03 03 03 03 03 03 03 03 03 03 03 03 
03 03 03 03 03 03 03 03 03 03 10 03 04 03 03 03 03 03 03 03 03 03 03 03 03 
03 03 03 10 10 09 10 03 03 10 10 10 10 10 03 02 02 02 02 02 02 02 03 03 03 
03 03 10 10 09 14 09 09 10 10 10 10 10 10 03 02 18 06 15 06 18 02 03 03 03 
03 10 10 09 14 14 14 14 09 10 10 10 10 10 10 02 06 12 06 04 04 03 03 03 03 
03 10 10 09 09 14 14 14 14 09 10 10 10 10 10 02 06 06 04 04 04 02 03 03 03 
03 10 10 10 09 14 14 14 14 09 10 10 04 04 10 04 06 04 04 04 04 04 03 03 03 
03 03 10 10 09 09 14 14 14 09 04 10 10 10 10 02 04 04 04 04 04 02 03 03 03 
03 10 10 10 10 09 09 14 09 10 10 10 10 10 10 02 02 03 03 03 03 03 03 03 03 
03 03 10 10 10 10 10 09 10 10 04 10 04 10 10 10 04 10 03 03 03 03 03 03 03 
03 10 10 10 10 10 10 10 04 10 10 04 10 10 10 10 10 10 10 10 03 03 03 03 03 
03 10 10 10 04 04 10 10 10 10 10 10 10 10 10 04 10 10 10 04 10 10 10 04 03 
19 04 10 10 04 04 10 10 10 04 10 04 10 04 10 10 04 04 10 04 04 04 04 04 19 
03 10 04 10 10 10 04 10 10 10 10 10 10 04 10 10 10 10 10 10 10 10 10 10 03 
03 10 10 10 10 10 04 10 04 10 10 04 10 10 04 10 10 10 03 10 04 03 03 03 03 
03 03 10 10 10 10 10 10 10 04 10 10 10 10 10 03 03 03 03 03 03 03 03 03 03 
03 03 03 03 10 10 10 04 04 10 10 10 10 10 03 03 03 03 03 03 03 03 03 03 03 
03 03 03 03 03 10 10 10 04 10 10 10 03 03 03 03 03 03 03 03 03 03 03 03 03 
03 03 03 03 03 03 03 03 10 04 10 03 03 03 03 03 03 03 03 03 03 03 03 03 03 
03 03 03 03 03 03 03 03 10 04 04 03 03 03 03 03 03 03 03 03 03 03 03 03 03 
03 03 03 03 03 03 03 03 03 10 04 10 03 03 03 03 03 03 03 03 03 03 03 03 03 
03 03 03 03 03 03 03 03 03 03 10 04 04 03 03 03 03 03 03 03 03 03 03 03 03 
03 03 03 03 03 03 03 03 03 03 03 04 04 03 03 03 03 03 03 03 03 03 03 03 03 
03 03 03 03 03 03 03 03 03 03 03 10 04 04 03 03 03 03 03 03 03 03 03 03 03 
03 03 03 03 03 03 03 03 03 03 03 03 20 03 03 03 03 03 03 03 03 03 03 03 03 
