03 03 03 03 03 03 03 03 03 03 03 03 03 03 03 03 03 03 03 03 03 03 03 03 03 
03 10 10 10 10 10 10 10 10 10 10 10 10 10 10 10 10 10 10 10 10 10 10 10 03 
03 10 10 10 10 10 10 03 03 10 03 03 10 03 03 03 04 03 03 04 03 03 10 10 03 
03 10 10 10 10 10 10 03 10 03 10 03 03 10 03 10 03 03 03 03 10 03 04 10 03 
03 10 10 10 10 10 10 10 10 10 10 03 10 03 03 03 03 04 03 10 03 10 10 10 03 
03 10 10 10 10 03 10 03 03 10 10 10 10 10 10 10 10 10 10 10 10 10 10 10 03 
03 10 03 10 03 03 10 10 10 10 10 10 10 10 10 10 10 10 10 10 10 10 10 10 03 
03 10 10 10 03 10 03 10 10 10 10 10 10 10 09 09 10 03 10 10 10 10 10 10 03 
03 10 10 10 10 10 10 10 10 03 10 10 10 09 09 09 10 10 10 03 10 10 04 10 03 
03 10 03 03 10 03 10 10 03 10 10 10 10 09 09 10 10 10 10 04 10 10 10 10 03 
03 10 10 10 10 10 10 10 10 10 10 03 09 09 09 10 10 03 10 10 10 10 10 10 03 
03 10 10 05 10 10 05 10 10 10 10 10 10 05 09 10 10 10 10 05 10 10 10 10 03 
19 04 04 04 04 05 04 04 04 04 05 04 05 09 05 05 04 04 05 04 04 05 04 05 19 
03 10 10 10 01 10 10 10 10 10 05 10 03 09 09 03 03 10 03 03 10 03 03 03 03 
03 10 05 05 05 10 10 10 04 10 10 10 03 09 09 03 03 03 03 03 04 10 04 03 03 
03 10 05 12 01 10 01 01 10 10 10 03 09 09 03 03 04 04 10 03 03 03 10 03 03 
03 01 01 01 01 10 10 01 04 10 10 03 09 09 03 03 03 10 10 03 03 10 10 10 03 
03 10 10 10 10 01 10 10 04 10 03 09 09 09 09 03 03 10 03 03 04 03 10 03 03 
03 10 10 10 10 10 10 04 10 10 09 09 09 09 09 09 10 10 04 03 03 03 10 04 03 
03 10 10 01 01 01 10 04 10 10 03 09 09 09 09 03 10 10 10 10 10 10 10 03 03 
03 10 10 10 10 10 10 10 04 10 03 03 03 03 03 03 03 04 03 03 04 03 10 03 03 
03 10 10 10 10 10 04 04 10 10 03 10 04 03 04 03 03 10 03 10 03 03 10 03 03 
03 10 10 10 04 04 04 04 04 10 03 10 10 03 10 10 03 10 10 03 10 10 03 03 03 
03 10 10 10 10 10 10 10 10 10 04 10 10 04 10 10 04 10 10 10 10 03 03 10 03 
03 03 03 03 03 03 03 03 03 03 03 03 03 03 03 03 03 03 03 03 03 03 03 03 03 
