03 03 03 03 03 03 03 03 03 03 03 03 03 03 03 03 03 03 03 03 03 03 03 03 03 
03 03 08 08 00 00 00 00 00 00 00 00 00 00 00 00 00 00 00 00 00 08 08 03 03 
03 03 08 08 00 15 15 15 15 15 00 07 07 07 07 07 07 07 07 07 00 08 08 03 03 
03 03 08 08 00 07 07 07 07 07 00 07 07 07 07 07 07 07 07 07 00 08 08 03 03 
03 03 08 08 00 07 07 07 07 07 00 07 07 07 07 07 07 07 07 07 00 08 08 03 03 
03 03 08 08 00 07 07 07 07 07 00 00 00 00 00 00 00 00 00 07 00 08 08 03 03 
03 03 08 08 00 07 07 07 07 07 00 05 05 05 05 05 05 05 00 07 00 21 08 03 03 
03 03 08 08 00 07 07 07 07 07 00 05 14 14 14 14 14 05 00 07 00 08 08 03 03 
03 03 08 08 00 00 00 00 00 07 00 05 14 14 14 14 14 05 00 07 00 08 08 03 03 
03 03 08 08 00 06 06 06 00 07 00 05 14 14 14 14 14 05 00 07 00 08 08 03 03 
03 03 08 08 00 06 12 06 00 07 00 05 14 14 14 14 14 05 00 07 00 08 08 03 03 
03 03 08 08 00 06 06 06 06 07 00 05 05 05 05 05 05 05 00 07 00 08 08 03 03 
03 03 08 08 00 06 06 06 00 07 00 00 00 00 00 07 00 00 00 07 00 08 08 03 03 
03 03 08 08 00 00 00 00 00 07 07 07 07 07 07 07 07 07 07 07 00 08 08 03 03 
03 03 08 08 00 07 07 07 07 07 00 07 07 07 07 07 07 07 07 07 00 08 08 03 03 
03 03 08 08 00 07 07 18 07 07 00 00 07 00 00 00 00 00 00 00 00 08 08 03 03 
03 03 08 08 00 07 07 07 07 07 00 08 05 08 08 08 08 08 08 08 08 08 08 03 03 
03 03 08 08 00 07 07 07 07 07 00 08 05 08 08 08 08 02 02 02 08 08 08 03 03 
03 03 08 08 00 00 00 00 00 00 00 08 05 08 08 08 02 14 14 14 02 08 08 03 03 
03 03 08 08 08 08 08 08 08 08 08 08 05 08 08 02 14 14 14 14 14 02 08 03 03 
03 03 08 08 08 08 08 08 08 08 08 08 05 08 08 02 14 14 02 14 14 02 08 03 03 
03 03 08 08 08 08 08 08 08 08 08 08 05 08 08 02 14 14 14 14 14 02 08 03 03 
03 03 08 08 08 08 08 08 08 08 08 08 05 08 08 08 02 14 14 14 02 08 08 03 03 
03 03 08 08 08 08 08 08 08 08 08 08 05 08 08 08 08 02 02 02 08 08 08 03 03 
03 03 03 03 03 03 03 03 03 03 03 03 20 03 03 03 03 03 03 03 03 03 03 03 03 
