13 13 13 13 13 13 13 13 13 13 13 13 13 13 13 13 13 13 13 13 13 13 13 13 13 
13 13 13 13 13 13 13 13 13 13 13 13 13 13 13 13 13 13 01 13 13 13 13 13 13 
13 13 13 13 13 13 13 13 13 13 13 13 13 13 13 13 13 13 13 13 13 13 13 13 13 
13 13 01 13 13 13 13 01 13 13 13 13 13 13 08 08 13 13 13 13 13 13 13 13 13 
13 01 01 13 13 13 13 13 13 13 13 13 13 08 08 08 08 13 13 13 13 13 13 13 13 
19 08 08 08 01 13 08 08 08 13 08 08 08 08 13 13 08 08 13 13 13 13 13 13 13 
19 08 08 08 08 08 08 13 08 08 08 01 08 13 13 01 08 08 13 13 01 01 01 13 13 
19 08 08 08 08 08 13 13 13 08 13 13 13 13 01 08 08 08 08 08 08 08 08 08 19 
13 13 13 01 08 08 08 13 01 01 13 13 13 13 08 08 08 08 08 08 08 08 08 08 19 
13 13 13 13 01 08 08 08 08 08 01 08 08 01 08 08 08 08 08 08 08 08 08 08 19 
13 13 13 13 13 08 08 08 08 08 08 01 01 01 08 08 08 01 13 13 13 13 13 13 13 
13 13 13 13 13 13 08 08 08 08 08 08 01 01 08 08 13 13 13 13 13 13 13 13 13 
13 13 13 13 13 13 08 08 13 01 13 13 13 13 05 05 13 13 13 13 13 13 13 13 13 
13 13 13 01 13 13 13 08 08 13 13 13 13 13 08 05 13 13 13 13 01 13 13 13 13 
13 13 13 13 13 13 13 08 01 08 13 13 13 13 05 08 13 13 13 13 13 13 13 13 13 
13 13 13 13 13 13 13 13 08 08 08 13 13 08 05 13 13 13 13 13 13 13 13 13 13 
13 13 13 13 08 08 08 13 13 08 08 13 13 01 05 13 13 13 13 13 13 13 13 13 13 
13 13 13 08 08 08 08 08 13 13 08 08 08 08 05 13 13 13 13 13 13 13 13 13 13 
13 13 13 13 08 08 13 08 13 13 13 08 05 05 13 13 13 13 13 13 13 13 13 13 13 
13 13 13 08 08 08 08 13 08 13 13 13 13 13 13 13 13 13 13 13 13 13 13 13 13 
13 13 13 13 13 08 08 13 13 13 13 13 13 13 13 13 13 13 13 13 13 13 13 13 13 
13 13 13 13 13 13 13 13 13 13 13 13 13 13 13 13 13 13 13 13 13 13 13 13 13 
13 13 13 13 13 13 13 13 13 13 13 13 13 13 13 13 13 13 13 13 13 13 13 13 13 
13 13 13 13 13 13 13 13 13 13 13 13 13 13 13 13 13 13 13 13 13 13 13 13 13 
13 13 13 13 13 13 13 13 13 13 13 13 13 13 13 13 13 13 13 13 13 13 13 13 13 
