03 03 03 03 03 03 03 03 03 03 03 03 03 03 03 03 03 03 03 03 03 03 03 03 03 
03 03 03 03 03 03 03 03 03 03 03 03 03 03 03 03 03 03 03 03 03 03 03 03 03 
03 03 03 03 03 03 03 03 00 00 00 00 00 00 00 00 00 00 00 00 03 03 03 03 03 
03 03 03 03 03 03 03 03 00 18 07 00 07 07 18 00 15 00 12 00 03 03 03 03 03 
03 03 03 03 03 03 03 03 00 07 07 00 07 07 07 00 07 07 07 00 03 03 03 03 03 
03 08 08 03 03 03 03 03 00 07 07 07 07 07 07 00 07 07 07 00 03 03 03 03 03 
03 08 08 03 03 08 08 03 00 07 00 00 00 00 00 00 07 07 07 00 03 03 08 03 03 
03 08 03 08 08 08 08 08 00 07 07 07 07 07 07 07 07 07 18 00 03 03 08 08 03 
03 08 03 08 08 03 08 08 00 00 00 00 00 00 00 07 00 00 00 00 03 08 08 03 03 
03 08 03 08 08 03 08 08 03 03 08 08 03 03 08 08 08 08 08 03 03 08 08 03 03 
03 08 03 08 08 03 03 08 08 08 08 08 08 08 08 08 08 08 08 08 08 08 03 03 03 
03 08 08 03 08 08 03 03 03 03 08 03 08 08 03 03 08 08 03 08 08 03 03 03 03 
03 08 08 03 08 08 03 03 03 03 03 03 03 03 03 03 08 08 03 03 03 03 03 03 03 
03 08 08 03 08 03 03 03 03 03 03 03 03 03 03 03 08 08 03 03 03 03 03 03 03 
03 08 03 08 08 03 03 03 03 03 03 03 03 03 03 03 08 08 03 03 03 08 08 03 03 
03 08 03 08 08 03 03 03 03 03 03 08 03 03 03 03 08 08 03 08 08 08 08 08 19 
03 08 03 08 08 03 03 03 03 08 08 08 08 03 03 03 08 08 03 08 08 08 08 08 03 
03 08 03 03 08 08 03 03 03 08 08 08 08 08 08 08 08 08 08 08 08 08 08 03 03 
03 08 08 03 08 08 03 03 03 08 08 08 08 08 08 08 08 08 03 03 03 08 03 03 03 
03 08 08 03 08 03 03 03 03 03 08 08 08 08 08 03 08 08 03 03 03 03 03 03 03 
03 08 08 08 08 03 03 03 03 03 03 08 08 08 03 03 08 08 03 03 03 03 03 03 03 
03 08 08 08 08 03 03 03 03 03 03 03 03 03 03 03 08 08 03 03 03 03 03 03 03 
03 03 03 03 03 03 03 03 03 03 03 03 03 03 03 03 08 08 03 03 03 03 03 03 03 
03 03 03 03 03 03 03 03 03 03 03 03 03 03 03 03 08 08 03 03 03 03 03 03 03 
03 03 03 03 03 03 03 03 03 03 03 03 03 03 03 03 20 20 03 03 03 03 03 03 03 
