03 03 03 03 03 03 03 03 03 03 03 03 03 03 03 03 20 20 03 01 01 01 01 01 03 
03 03 03 03 03 08 08 03 03 08 03 03 03 03 03 08 08 08 01 08 08 08 08 08 19 
03 03 03 08 08 08 08 08 08 08 08 08 03 03 08 08 08 01 08 08 08 13 13 13 01 
03 03 08 08 08 01 01 01 01 01 01 08 08 08 08 08 01 11 08 07 13 13 13 13 01 
03 03 08 01 01 11 08 08 08 08 24 01 08 08 08 01 08 08 08 07 13 07 13 13 01 
03 03 05 05 08 08 08 13 13 08 08 08 01 01 01 08 08 08 13 07 13 07 08 18 01 
03 05 05 08 08 13 13 13 13 13 13 08 08 08 08 08 13 13 13 07 13 08 08 01 03 
03 03 03 01 08 08 13 11 13 13 13 13 13 13 08 13 13 13 13 07 08 08 01 03 03 
03 03 03 03 01 08 08 08 08 08 08 11 13 13 13 13 13 13 13 07 08 08 01 03 03 
03 03 03 03 03 01 01 01 01 01 08 08 08 13 13 24 08 13 08 08 08 01 03 03 03 
03 03 03 03 03 03 03 03 03 03 01 01 08 08 13 08 08 08 08 08 01 03 03 03 03 
03 03 03 03 03 03 03 03 14 03 03 03 01 08 08 08 01 01 01 01 03 03 03 03 03 
03 03 03 03 03 03 03 14 14 14 03 03 03 01 01 01 03 03 03 03 03 03 03 03 03 
03 03 03 03 03 03 14 14 14 14 14 03 03 03 03 03 03 03 03 03 03 03 03 03 03 
03 03 03 03 03 03 03 14 14 14 14 03 03 03 03 03 03 03 03 03 03 03 03 03 03 
03 03 03 03 03 03 03 03 14 14 03 03 03 03 03 03 03 03 03 03 03 03 03 03 03 
03 03 03 03 03 03 03 03 03 14 03 03 03 03 03 03 03 03 03 03 03 03 03 03 03 
03 03 03 03 03 03 03 03 14 14 03 03 03 03 03 03 03 03 03 03 03 03 03 03 03 
03 03 03 03 03 03 03 03 03 14 14 03 03 03 03 03 03 03 03 03 03 03 03 03 03 
03 03 03 03 03 03 03 03 14 14 14 14 03 03 03 03 03 03 03 03 03 03 03 03 03 
03 03 03 03 03 03 03 14 14 14 14 03 03 03 03 03 03 03 03 03 03 03 03 03 03 
03 03 03 03 03 03 14 14 14 14 03 03 03 03 03 03 03 03 03 03 03 03 03 03 03 
03 03 03 03 03 03 03 14 14 14 14 03 03 03 03 03 03 03 03 03 03 03 03 03 03 
03 03 03 03 03 03 03 03 14 14 03 03 03 03 03 03 03 03 03 03 03 03 03 03 03 
03 03 03 03 03 03 03 14 14 14 14 03 03 03 03 03 03 03 03 03 03 03 03 03 03 
