13 13 13 02 02 02 02 02 02 02 02 02 02 02 02 02 20 20 20 02 02 13 13 13 13 
13 13 08 02 08 08 08 08 08 08 08 08 08 08 02 08 08 08 08 08 02 13 13 13 13 
13 08 08 02 08 08 08 08 08 08 08 08 08 08 02 08 08 08 08 08 02 13 13 13 13 
13 08 08 02 08 08 08 08 08 08 08 08 08 08 02 08 08 08 08 08 02 13 13 13 13 
13 13 08 02 08 08 08 08 08 08 08 08 08 08 02 08 08 08 08 08 02 13 13 13 13 
13 13 13 02 08 08 08 08 08 08 08 08 08 08 02 08 08 08 08 08 02 13 13 13 13 
13 13 13 02 02 02 02 02 02 02 02 02 02 08 02 08 08 08 08 08 02 13 13 13 13 
19 08 13 02 08 08 08 08 08 08 08 02 08 08 02 08 08 08 08 08 05 05 05 05 19 
19 08 08 08 08 08 08 08 08 08 08 02 08 08 02 08 08 08 08 08 05 05 05 05 19 
19 08 13 02 08 08 08 08 08 08 08 02 08 08 02 08 08 08 08 08 05 05 05 05 19 
13 13 02 02 02 02 02 08 08 08 08 08 08 08 02 08 08 02 02 02 02 02 13 13 13 
13 02 05 05 05 02 02 08 08 08 08 02 08 08 08 08 08 02 02 05 05 05 02 13 13 
02 05 05 05 05 05 02 02 02 02 02 02 08 02 02 02 02 02 05 05 05 05 05 02 13 
02 05 05 05 05 05 05 08 08 08 08 08 08 02 02 02 02 02 05 05 05 05 05 02 13 
02 05 05 05 05 05 02 02 02 02 02 02 02 02 02 02 02 02 05 05 05 05 05 02 13 
13 02 05 05 05 02 13 13 13 13 13 13 13 13 13 13 13 13 02 05 05 05 02 13 13 
13 13 02 05 02 13 13 08 08 13 13 13 13 13 13 13 13 13 13 02 02 02 13 13 13 
13 13 08 08 08 13 08 01 01 08 13 13 13 13 13 13 13 13 13 13 13 13 13 13 13 
13 13 08 08 08 08 01 13 13 01 08 13 13 13 13 13 13 13 13 13 13 13 13 13 13 
13 13 08 08 08 08 01 13 13 13 01 01 13 13 13 13 13 13 13 13 13 13 13 13 13 
13 13 08 08 08 13 08 01 01 01 08 13 13 13 13 13 13 13 13 13 13 13 13 13 13 
13 13 08 08 08 13 13 01 08 13 13 13 13 13 13 13 13 13 13 13 13 13 13 13 13 
13 13 08 08 08 13 13 13 13 13 13 13 13 13 13 13 13 13 13 13 13 13 13 13 13 
13 13 08 08 08 13 13 13 13 13 13 13 13 13 13 13 13 13 13 13 13 13 13 13 13 
13 13 20 20 20 13 13 13 13 13 13 13 13 13 13 13 13 13 13 13 13 13 13 13 13 
