13 13 20 20 20 13 13 13 13 13 13 13 13 13 13 13 13 13 13 13 13 13 13 13 13 
13 13 08 08 08 08 08 08 08 08 08 08 08 08 08 08 13 13 13 13 13 13 13 13 13 
13 13 08 08 08 08 08 08 08 08 08 08 08 08 08 08 08 13 13 13 13 13 13 13 13 
13 13 13 08 08 08 08 08 08 08 08 08 08 08 08 08 08 13 13 13 13 13 13 13 13 
13 13 13 13 08 08 08 02 02 02 02 02 02 02 08 08 08 02 02 02 02 02 02 02 13 
13 13 13 13 08 08 08 02 08 08 08 08 08 08 08 08 08 02 15 08 08 08 08 02 13 
13 13 13 13 08 08 08 02 08 08 08 08 08 08 08 08 08 02 08 08 08 08 08 02 13 
13 13 13 13 08 08 08 02 08 08 08 08 08 08 08 08 08 02 08 08 08 08 08 02 13 
13 13 13 13 08 08 08 02 02 02 02 02 08 02 02 02 02 02 02 02 02 02 08 02 13 
13 13 13 13 08 08 08 08 08 08 08 08 08 08 08 08 08 08 08 08 08 08 08 02 13 
13 13 13 13 08 08 08 08 08 08 08 08 08 08 08 08 08 08 08 08 08 08 08 02 13 
13 13 13 13 13 08 08 08 08 08 08 08 08 02 02 02 02 02 02 02 02 02 08 02 13 
13 13 13 13 13 13 13 02 02 02 02 02 08 02 08 08 08 08 08 08 08 08 08 02 13 
13 13 13 13 13 13 13 02 08 08 08 08 08 02 08 08 08 08 08 08 08 08 08 02 13 
13 13 13 13 13 13 13 02 08 08 08 08 08 02 08 08 08 08 08 08 08 08 08 02 13 
13 13 13 13 13 13 13 02 02 02 02 02 02 02 08 08 08 02 02 02 02 02 02 02 13 
13 13 13 13 13 13 13 13 13 13 13 13 13 13 08 08 08 13 13 13 13 13 13 13 13 
13 13 13 13 13 13 13 13 13 13 13 13 13 13 08 08 08 13 13 13 13 13 13 13 13 
13 13 13 13 13 13 13 13 13 13 13 13 13 13 08 08 08 13 13 13 13 13 13 13 13 
13 13 13 13 13 13 13 13 13 13 13 13 13 13 08 08 08 13 13 13 13 13 13 13 13 
13 13 13 13 13 13 13 13 13 13 13 13 13 13 08 08 08 13 13 13 13 13 13 13 13 
13 13 13 13 13 13 13 13 13 13 13 13 13 13 08 08 08 13 13 13 13 13 13 13 13 
13 13 13 13 13 13 13 13 13 13 02 02 13 13 08 08 08 13 13 02 02 13 13 13 13 
13 13 13 13 13 13 13 13 13 02 05 05 02 13 08 08 08 13 02 05 05 02 13 13 13 
13 13 13 13 13 13 13 13 02 05 05 05 05 02 20 20 20 02 05 05 05 05 02 13 13 
