13 13 13 13 13 13 05 02 05 12 12 05 02 01 20 20 20 01 02 05 12 12 05 02 13 
13 13 13 13 05 05 13 13 02 05 05 02 13 12 05 05 24 12 13 02 05 05 02 13 13 
13 13 13 05 05 13 02 02 13 02 02 13 13 01 05 05 05 01 13 13 02 02 13 02 02 
13 13 13 13 13 02 05 05 02 13 13 13 13 12 05 05 05 12 13 13 13 13 02 05 05 
05 05 05 13 02 05 05 05 05 02 13 13 13 01 24 05 05 01 13 13 13 02 05 05 05 
05 05 03 02 05 05 05 12 05 18 02 13 13 12 05 05 05 12 13 13 02 18 05 12 05 
03 03 03 02 05 05 12 05 05 05 02 13 13 01 05 05 05 01 13 13 02 05 05 05 12 
03 03 03 03 02 05 05 05 05 02 13 13 13 12 05 05 24 12 13 13 13 02 05 05 05 
03 03 03 03 03 02 05 05 02 13 13 13 13 01 05 05 05 01 13 13 13 13 02 05 05 
19 05 05 03 03 03 02 02 13 13 13 13 13 12 05 05 05 12 13 13 13 13 13 02 02 
03 03 05 05 03 03 03 03 03 03 13 13 13 05 05 05 05 05 13 13 13 03 03 03 03 
03 03 03 05 03 03 03 03 03 03 03 13 13 13 05 05 05 13 13 13 03 03 03 03 03 
03 03 03 05 03 03 03 03 03 03 03 03 13 13 13 05 13 13 13 03 03 03 03 03 03 
03 03 03 05 03 03 03 03 03 03 03 03 03 03 13 05 13 13 03 03 03 03 03 03 03 
03 03 03 05 03 03 03 03 03 03 03 03 03 03 03 05 03 03 03 03 03 03 03 03 03 
03 03 03 05 03 03 03 03 03 03 03 03 03 03 03 05 03 03 03 03 03 03 03 03 03 
03 03 03 05 03 03 03 03 03 03 03 03 03 03 03 05 03 03 03 03 03 03 03 03 03 
03 03 03 05 03 03 03 01 01 01 01 01 03 03 03 05 03 03 03 03 03 03 03 03 03 
03 03 03 05 03 03 03 01 05 05 05 01 03 03 03 05 03 03 03 03 03 03 03 03 03 
03 03 03 05 03 03 03 01 05 12 05 01 03 03 03 05 05 05 05 05 05 05 05 05 19 
03 03 03 05 03 03 03 01 05 05 05 01 03 03 03 05 03 03 03 03 03 03 03 03 03 
03 03 03 05 05 03 03 01 01 05 01 01 03 03 05 05 03 03 03 03 03 03 03 03 03 
03 03 03 03 05 05 05 05 05 05 05 05 05 05 05 03 03 03 03 03 03 03 03 03 03 
03 03 03 03 03 03 03 03 03 03 03 03 03 03 03 03 03 03 03 03 03 03 03 03 03 
03 03 03 03 03 03 03 03 03 03 03 03 03 03 03 03 03 03 03 03 03 03 03 03 03 
