03 03 03 03 03 03 03 03 03 03 20 03 03 03 03 03 03 03 03 03 03 03 03 03 03 
03 03 03 03 03 03 03 03 03 08 08 03 03 03 08 08 03 03 03 03 03 03 03 03 03 
03 03 03 03 03 08 08 03 08 08 08 08 03 08 08 08 08 03 08 08 03 03 03 03 03 
03 03 03 03 08 08 08 08 08 03 08 08 08 08 08 08 08 08 08 08 03 03 08 03 03 
03 03 14 03 08 08 08 08 08 03 08 03 08 08 03 01 01 08 08 08 08 03 08 08 19 
03 14 14 08 08 08 08 03 03 03 03 03 03 03 01 05 05 05 08 08 08 03 08 08 03 
03 14 14 14 03 03 03 03 03 03 03 03 03 01 11 05 05 01 08 08 08 08 08 03 03 
03 03 03 14 14 03 03 03 03 03 03 03 01 15 05 05 05 01 03 08 08 08 03 03 03 
14 14 14 14 14 03 03 03 03 03 03 03 01 05 05 05 01 03 03 03 08 03 03 03 03 
14 14 03 14 14 14 03 03 03 03 03 03 03 01 05 01 03 03 03 08 08 03 03 03 03 
03 14 14 14 14 14 03 03 03 03 03 03 03 03 01 03 03 03 03 08 08 08 03 03 03 
03 14 14 14 14 03 03 03 03 03 03 03 03 03 03 03 03 03 03 03 08 08 03 03 03 
03 03 14 14 03 03 03 03 03 03 03 03 03 03 03 03 03 03 03 08 08 03 03 03 03 
03 03 14 14 03 03 03 03 03 03 03 03 03 08 08 08 03 03 08 08 08 03 03 03 03 
03 03 14 14 03 03 03 03 03 03 03 03 08 08 08 08 03 08 08 03 03 03 03 03 03 
03 03 03 14 03 03 03 03 03 03 03 03 08 08 03 08 08 08 03 03 03 03 03 03 03 
03 03 14 14 03 08 08 08 03 03 03 03 03 03 03 03 08 03 03 03 03 03 03 03 03 
03 03 07 07 07 08 03 08 08 03 03 03 03 03 03 03 08 03 03 03 03 03 03 03 03 
03 03 08 14 14 08 03 03 08 08 08 03 03 08 08 08 08 03 03 03 03 03 03 03 03 
19 08 08 14 14 14 03 08 08 08 08 08 03 03 08 08 03 03 03 03 03 03 03 03 03 
03 03 14 14 14 14 08 08 03 03 08 08 08 08 08 03 03 03 03 03 03 03 03 03 03 
03 03 03 14 14 14 08 08 08 03 03 03 08 08 03 03 03 03 03 03 03 03 03 03 03 
03 03 03 14 03 03 03 03 08 08 08 08 08 03 03 03 03 03 03 03 03 03 03 03 03 
03 03 03 03 03 03 03 03 03 03 08 08 03 03 03 03 03 03 03 03 03 03 03 03 03 
03 03 03 03 03 03 03 03 03 03 03 03 03 03 03 03 03 03 03 03 03 03 03 03 03 
