03 03 03 03 03 03 03 03 03 03 03 03 20 03 03 03 03 03 03 03 03 03 03 03 03 
03 03 03 03 03 03 03 03 03 03 03 03 05 03 03 03 03 03 03 03 03 03 03 03 03 
03 03 03 03 03 03 03 03 03 03 03 08 05 03 03 03 03 03 03 03 03 03 03 03 03 
03 03 03 03 03 03 03 03 03 03 03 08 05 03 03 03 03 03 03 03 03 03 03 03 03 
03 03 03 03 03 03 03 03 03 03 08 08 05 08 08 03 03 03 03 03 03 03 03 03 03 
03 03 03 03 03 03 03 03 03 08 08 08 05 08 08 08 03 03 03 03 03 03 03 03 03 
03 03 03 03 03 03 03 03 08 08 08 08 05 08 08 08 03 03 03 03 03 03 03 03 03 
03 03 03 03 03 03 08 08 08 03 08 08 05 08 08 08 03 03 03 03 03 03 03 03 03 
03 03 03 08 08 08 08 08 08 08 03 08 05 08 08 08 08 03 03 03 03 03 03 03 03 
03 03 08 08 08 08 03 08 08 08 08 08 05 17 08 08 08 08 03 03 03 03 03 03 03 
03 08 08 08 08 08 08 08 08 08 17 08 05 08 08 08 08 08 08 03 03 03 03 03 03 
19 05 05 05 05 05 05 05 05 05 05 05 05 08 08 08 08 08 08 08 03 03 03 03 03 
03 08 08 08 08 08 08 08 08 08 08 03 05 08 08 08 08 08 08 08 03 03 03 03 03 
03 03 08 08 08 08 08 08 08 08 08 08 05 17 08 08 08 08 08 08 03 03 03 03 03 
03 03 08 08 08 08 08 08 08 08 08 08 05 08 08 08 08 08 08 03 03 03 03 03 03 
03 03 03 08 08 08 08 08 08 08 08 08 05 08 08 08 08 03 03 03 03 03 03 03 03 
03 03 03 08 08 08 08 03 03 03 08 08 05 08 08 08 03 03 03 03 03 03 03 03 03 
03 03 03 03 08 08 08 03 03 03 03 08 05 08 08 08 03 03 03 03 03 03 03 03 03 
03 03 03 03 08 08 08 03 03 03 03 08 05 08 08 03 03 03 03 03 03 03 03 03 03 
03 03 03 03 03 08 03 03 03 03 03 03 05 03 03 03 03 03 03 03 03 03 03 03 03 
03 03 03 03 03 03 03 03 03 03 03 03 05 03 03 03 03 03 03 03 03 03 03 03 03 
03 03 03 03 03 03 03 03 03 03 03 03 05 03 03 03 03 03 03 03 03 03 03 03 03 
03 03 03 03 03 03 03 03 03 03 03 03 05 03 03 03 03 03 03 03 03 03 03 03 03 
03 03 03 03 03 03 03 03 03 03 03 03 05 03 03 03 03 03 03 03 03 03 03 03 03 
03 03 03 03 03 03 03 03 03 03 03 03 20 03 03 03 03 03 03 03 03 03 03 03 03 
