03 03 03 03 08 14 14 03 03 03 03 03 03 03 03 03 03 03 03 03 03 03 03 03 03 
03 03 03 08 08 14 14 08 08 08 08 08 08 03 03 03 03 03 03 03 03 03 03 03 03 
03 03 03 08 14 14 14 14 14 08 08 08 08 08 03 03 03 03 03 03 03 03 03 03 03 
03 08 08 08 14 14 14 08 14 14 08 08 08 08 08 03 03 08 15 08 03 03 03 03 03 
08 08 14 14 14 14 08 08 08 14 14 14 08 08 08 08 08 08 08 08 08 03 03 03 03 
14 14 14 14 14 08 08 08 08 08 08 14 14 08 08 08 08 08 08 08 08 08 03 03 03 
14 14 14 14 08 08 08 08 08 08 08 08 14 14 14 08 08 08 08 08 08 08 03 03 03 
14 14 08 08 08 08 08 08 08 08 08 08 08 08 14 14 08 08 08 08 08 08 03 03 03 
03 08 08 08 08 08 08 05 05 05 08 08 08 08 08 14 14 14 08 08 08 08 03 03 03 
03 08 08 08 08 08 05 05 05 05 05 08 08 08 08 08 08 14 14 08 08 08 08 08 03 
03 08 08 08 08 05 05 05 05 05 05 05 08 08 08 08 08 08 14 08 08 18 08 08 03 
03 08 08 08 08 05 05 05 03 05 05 05 05 05 05 05 05 05 05 05 05 05 05 05 19 
03 08 08 08 08 05 05 05 05 05 05 05 08 08 08 08 08 08 14 14 08 08 08 17 03 
03 08 08 08 08 08 05 05 05 05 05 08 08 08 08 08 08 08 08 14 08 08 08 08 03 
03 08 08 08 08 08 08 05 05 05 08 08 08 08 08 08 08 08 08 14 14 08 08 08 03 
03 08 08 08 08 08 08 08 08 08 08 08 14 14 14 14 14 08 14 14 14 14 08 08 03 
03 08 08 08 08 08 14 14 14 14 14 14 14 14 14 14 14 14 14 14 14 14 08 08 03 
03 08 08 14 14 14 14 14 14 14 14 14 14 14 14 14 14 14 14 14 14 14 14 08 03 
08 14 14 14 14 14 14 14 14 14 14 14 14 14 14 14 14 14 14 14 14 14 14 14 03 
14 14 14 14 14 14 14 14 14 14 14 14 14 14 14 14 14 14 14 14 14 14 14 14 14 
14 14 14 14 14 14 14 14 14 14 14 14 14 14 14 14 14 14 14 14 14 14 14 14 14 
14 14 14 14 14 14 14 14 14 14 14 14 14 14 14 14 14 14 14 14 14 14 14 14 14 
14 14 14 14 14 14 14 14 14 14 14 14 14 14 14 14 14 14 14 14 14 14 14 14 14 
14 14 14 14 14 14 14 14 14 14 14 14 14 14 14 14 14 14 14 14 14 14 14 14 14 
14 14 14 14 14 14 14 14 14 14 14 14 14 14 14 14 14 14 14 14 14 14 14 14 14 
