01 01 01 01 01 01 01 01 01 01 01 01 01 01 01 20 01 01 01 01 01 01 01 01 01 
01 01 01 01 01 01 01 01 01 01 01 01 01 01 01 08 01 01 01 01 01 01 01 01 01 
01 01 01 01 01 01 01 01 01 01 01 01 01 01 08 08 08 01 01 01 01 01 01 01 01 
01 01 01 01 01 01 01 01 01 08 08 08 08 08 08 08 08 01 01 01 01 01 01 01 01 
01 01 01 01 01 01 01 08 08 08 01 01 01 01 08 08 08 01 01 01 01 01 01 01 01 
01 01 01 01 01 01 01 08 01 01 01 01 01 01 08 08 08 01 01 01 01 01 01 01 01 
01 01 01 01 01 01 08 08 08 01 01 01 01 01 08 08 08 01 01 01 01 08 08 01 01 
01 01 01 01 01 08 08 08 08 08 01 01 01 01 08 08 08 01 01 01 08 18 08 08 01 
01 01 01 01 08 08 01 01 01 08 08 01 01 01 08 01 01 01 01 01 08 08 08 08 01 
01 01 01 01 08 08 01 01 01 01 08 01 01 08 08 01 01 01 01 01 01 08 08 08 01 
01 01 01 01 08 08 01 01 01 01 08 08 08 08 01 01 01 01 01 01 08 08 08 01 01 
01 01 01 01 08 08 01 01 01 01 01 08 08 01 01 01 01 01 08 08 08 08 08 19 01 
01 01 01 01 01 08 08 01 01 01 01 08 08 01 01 01 01 08 08 08 08 08 01 01 01 
01 01 01 01 01 08 08 01 01 01 01 08 08 01 01 01 08 08 08 08 08 01 01 01 01 
01 23 08 01 01 01 08 01 01 01 01 08 08 01 01 08 08 08 08 08 01 01 01 01 01 
01 08 24 01 01 01 01 01 01 01 01 08 08 08 08 08 08 08 01 01 01 01 01 01 01 
01 01 08 08 01 01 01 01 01 01 01 01 08 08 08 08 08 01 01 01 01 01 01 01 01 
01 01 08 08 08 08 08 01 01 01 01 08 08 08 08 08 08 01 01 01 01 01 01 01 01 
01 01 01 08 08 08 08 08 08 08 08 08 08 08 08 08 08 01 01 01 01 01 01 01 01 
01 01 01 01 01 01 08 08 08 08 08 08 01 01 01 01 08 08 01 01 01 01 01 01 01 
01 01 01 01 01 01 01 01 01 01 01 01 01 01 01 01 08 08 08 01 01 01 01 01 01 
01 01 01 01 01 01 01 01 01 01 01 01 01 01 01 01 01 08 08 08 01 01 01 01 01 
01 01 01 01 01 01 01 01 01 01 01 01 01 01 01 01 01 01 08 08 01 01 01 01 01 
01 01 01 01 01 01 01 01 01 01 01 01 01 01 01 01 01 01 08 08 01 01 01 01 01 
01 01 01 01 01 01 01 01 01 01 01 01 01 01 01 01 01 01 20 01 01 01 01 01 01 
