01 01 01 01 01 01 01 01 01 01 01 01 01 01 01 01 01 01 20 01 01 01 01 01 01 
01 01 01 01 01 01 01 01 01 01 01 01 01 01 01 01 01 01 08 01 01 01 01 01 01 
01 01 01 01 08 08 08 01 01 01 01 01 01 01 01 01 01 01 08 01 01 01 01 01 01 
01 01 01 08 08 18 08 08 08 01 01 01 01 01 01 01 01 01 08 01 01 01 01 01 01 
01 01 01 08 08 08 08 08 08 08 01 01 01 01 01 01 08 08 08 08 08 01 01 01 01 
01 01 01 08 08 08 08 08 08 08 01 01 01 01 08 08 08 01 08 01 08 08 08 01 01 
01 01 01 01 08 08 08 08 08 01 01 08 08 08 08 01 01 01 08 01 08 01 08 01 01 
01 01 01 01 01 08 08 11 11 01 08 08 01 01 01 01 01 01 11 01 08 01 08 01 01 
01 01 01 01 01 11 08 08 08 01 08 01 01 01 01 01 01 01 01 08 08 01 08 01 01 
01 01 01 01 01 01 01 01 08 08 01 01 01 01 01 01 01 01 08 08 01 01 08 01 01 
01 01 01 01 01 08 08 08 08 01 01 01 01 01 01 01 01 08 08 01 01 01 08 01 01 
01 01 01 01 08 08 01 01 08 08 08 01 01 01 01 01 08 08 01 01 01 08 08 01 01 
01 01 01 01 08 01 01 01 01 01 08 08 08 08 08 08 08 01 01 01 01 08 01 01 01 
01 01 01 08 08 01 01 01 01 01 08 08 01 01 01 01 01 01 01 01 08 08 01 01 01 
01 01 01 08 01 01 01 08 08 08 08 08 08 01 01 01 01 13 13 08 08 01 01 01 01 
01 01 08 08 01 01 08 08 08 08 01 01 08 01 01 01 13 13 08 08 13 01 01 01 01 
01 01 08 01 01 01 08 08 08 01 01 01 08 01 01 01 13 13 13 13 13 01 01 01 01 
01 08 08 01 01 01 01 08 08 01 01 01 01 08 01 01 08 08 08 08 08 01 01 01 01 
01 08 01 01 01 01 01 01 01 01 01 01 08 01 01 08 08 01 01 01 08 08 01 01 01 
01 08 08 01 01 01 01 08 08 08 08 01 08 01 08 08 01 01 01 01 01 08 08 01 01 
01 01 08 08 01 08 08 08 01 01 08 08 08 08 08 01 01 01 01 01 01 01 08 08 19 
01 01 01 08 08 08 01 01 01 01 01 08 08 08 01 01 01 01 01 01 01 01 01 01 01 
01 01 01 01 01 01 01 01 01 01 01 01 01 01 01 01 01 01 01 01 01 01 01 01 01 
01 01 01 01 01 01 01 01 01 01 01 01 01 01 01 01 01 01 01 01 01 01 01 01 01 
01 01 01 01 01 01 01 01 01 01 01 01 01 01 01 01 01 01 01 01 01 01 01 01 01 
