03 03 03 03 03 03 03 03 03 03 03 03 03 20 03 03 03 03 03 03 03 03 03 03 03 
03 10 10 10 10 10 10 10 10 10 10 10 10 10 10 03 03 03 03 03 03 03 03 03 03 
03 10 09 09 10 10 10 10 10 10 10 10 10 10 10 03 03 03 03 03 03 03 03 03 03 
03 09 06 06 09 10 10 10 10 10 10 10 10 10 03 03 03 03 03 03 03 03 03 03 03 
03 09 06 18 06 09 10 10 10 10 10 10 10 10 03 03 03 03 03 03 03 03 03 03 03 
03 09 06 06 06 06 10 10 10 10 10 10 10 10 10 03 03 03 03 03 03 03 03 03 03 
03 09 06 06 06 09 10 10 10 10 10 10 10 10 10 03 03 03 03 03 03 03 03 03 03 
03 09 06 06 09 10 10 10 10 10 10 10 10 10 03 03 03 03 03 03 03 03 03 03 03 
03 10 09 09 10 10 10 10 10 10 10 10 10 10 10 03 03 03 03 03 03 03 03 03 03 
03 10 10 10 10 10 10 10 10 10 10 10 10 10 10 10 10 03 03 03 03 03 03 03 03 
03 10 10 10 10 10 10 10 10 10 10 03 10 10 10 10 10 10 03 03 03 03 03 03 03 
03 10 10 10 10 10 10 10 10 10 10 03 03 10 10 10 10 10 10 10 03 03 10 10 03 
03 10 10 10 10 10 10 10 10 10 03 03 03 03 10 10 10 10 10 10 10 10 10 10 03 
03 10 10 10 10 10 10 10 10 10 03 03 03 03 10 10 10 10 10 10 10 10 10 10 19 
03 03 10 10 10 10 10 03 03 10 03 03 03 03 03 03 10 10 10 10 10 10 10 10 03 
03 03 03 10 10 10 03 03 03 10 10 10 03 03 03 10 10 10 10 10 10 10 10 10 03 
03 03 03 03 10 03 03 10 10 10 10 10 03 03 03 03 10 10 10 03 03 10 10 10 03 
03 03 03 03 03 03 03 10 10 10 10 10 03 03 03 03 10 10 03 03 03 10 10 10 03 
03 03 03 03 03 10 10 10 10 10 10 10 03 03 03 03 03 03 03 03 03 03 10 10 03 
03 03 03 03 03 03 10 10 10 10 10 03 03 03 03 03 03 03 10 03 03 03 10 10 03 
03 03 03 03 03 03 10 10 10 10 10 03 03 03 03 03 10 10 10 10 03 03 10 10 03 
03 03 03 03 03 03 10 10 10 10 03 03 03 03 03 03 05 05 05 10 03 03 10 10 03 
03 03 03 03 03 03 03 03 10 03 03 03 03 03 03 03 13 13 05 05 05 10 10 10 03 
03 03 03 03 03 03 03 03 10 03 03 03 03 03 03 03 09 05 05 13 05 03 10 10 03 
03 03 03 03 03 03 03 03 03 03 03 03 03 03 03 03 03 03 03 03 03 03 03 03 03 
