13 13 13 13 13 13 13 13 13 13 13 13 13 13 13 13 13 13 13 13 13 13 13 13 13 
13 13 13 13 13 13 13 13 13 13 13 13 13 13 13 13 13 13 13 13 13 13 13 13 13 
13 13 13 13 13 13 13 13 13 13 13 13 13 13 13 13 13 13 13 13 13 13 13 13 13 
13 13 13 13 13 13 13 13 13 13 13 13 13 13 13 13 13 13 13 13 13 13 13 13 13 
13 13 13 13 13 13 01 01 01 01 01 01 13 13 13 13 13 13 13 13 13 13 13 13 13 
13 13 13 13 13 13 01 07 05 05 05 01 13 13 13 13 13 13 13 13 13 13 13 13 13 
13 13 13 13 13 13 01 05 05 24 05 01 13 13 13 13 13 13 13 13 13 13 13 13 13 
13 13 13 13 13 13 01 05 05 05 05 01 13 13 13 13 13 13 13 13 13 13 13 13 13 
13 13 13 13 13 13 01 05 05 05 05 01 13 13 13 13 13 13 13 13 13 13 02 05 02 
13 13 13 13 13 13 01 05 05 05 05 02 05 05 05 05 05 05 05 05 05 02 05 05 19 
13 13 13 13 13 13 01 05 05 05 05 02 05 12 05 12 05 12 05 12 05 05 05 05 19 
13 13 13 13 13 13 01 24 05 05 05 02 05 05 05 05 05 05 05 05 05 02 05 05 19 
13 13 13 13 13 13 01 05 05 05 05 01 13 13 13 13 13 13 13 13 13 13 02 05 02 
13 13 13 13 13 13 01 05 05 05 05 01 13 13 13 13 13 13 13 13 13 13 13 13 13 
13 13 13 13 13 13 01 05 05 24 05 01 13 13 13 13 13 13 13 13 13 13 13 13 13 
13 13 13 13 13 13 01 05 05 05 05 01 13 13 13 13 13 13 13 13 13 13 13 13 13 
13 13 13 13 13 13 01 01 01 01 01 01 13 13 13 13 13 13 13 13 13 13 13 13 13 
13 13 13 13 13 13 13 13 13 13 13 13 13 13 13 13 13 13 13 13 13 13 13 13 13 
13 13 13 13 13 13 13 13 13 13 13 13 13 13 13 13 13 13 13 13 13 13 13 13 13 
13 13 13 13 13 13 13 13 13 13 13 13 13 13 13 13 13 13 13 13 13 13 13 13 13 
13 13 13 13 13 13 13 13 13 13 13 13 13 13 13 13 13 13 13 13 13 13 13 13 13 
13 13 13 13 13 13 13 13 13 13 13 13 13 13 13 13 13 13 13 13 13 13 13 13 13 
13 13 13 13 13 13 13 13 13 13 13 13 13 13 13 13 13 13 13 13 13 13 13 13 13 
13 13 13 13 13 13 13 13 13 13 13 13 13 13 13 13 13 13 13 13 13 13 13 13 13 
13 13 13 13 13 13 13 13 13 13 13 13 13 13 13 13 13 13 13 13 13 13 13 13 13 
