03 03 03 03 03 03 03 03 03 03 03 03 03 03 03 03 03 03 03 03 03 03 03 03 03 
03 10 10 10 10 10 10 10 10 10 10 10 10 10 10 10 10 10 10 14 14 14 10 10 03 
03 10 10 10 10 10 10 10 10 10 10 10 10 10 10 10 10 10 10 14 14 10 10 10 03 
03 10 10 10 10 10 10 10 10 10 10 10 10 10 10 10 10 10 14 14 14 10 10 10 03 
03 10 03 10 10 10 10 10 10 10 10 10 10 10 10 10 10 10 14 14 04 10 10 10 03 
03 03 10 03 10 10 10 10 10 10 10 10 10 10 10 10 10 10 14 14 04 10 10 10 03 
03 03 10 10 03 10 10 10 10 10 10 10 04 04 10 04 10 14 14 14 04 04 10 10 03 
03 03 10 10 10 03 03 03 03 03 03 03 10 10 10 10 14 14 14 04 04 10 10 10 03 
03 03 03 10 10 10 10 10 10 10 10 10 03 10 10 14 14 14 14 10 10 10 10 10 03 
03 03 03 10 02 02 02 02 02 02 02 10 04 03 10 10 14 14 14 10 10 10 10 10 03 
03 03 10 10 02 06 06 06 06 06 02 02 10 10 03 03 01 12 01 03 03 03 03 03 03 
03 03 10 10 02 06 06 06 06 06 06 02 10 10 05 05 05 05 18 05 05 05 05 05 03 
03 03 10 10 02 15 06 06 06 06 06 06 10 04 05 05 05 05 05 05 05 05 05 05 19 
03 03 03 10 02 06 06 06 18 06 06 02 10 04 05 05 05 05 05 05 05 05 05 05 03 
03 03 03 03 02 06 06 06 06 06 02 02 10 10 03 03 01 12 01 03 03 03 03 03 03 
03 03 03 10 02 02 02 02 02 02 02 10 10 03 10 10 14 14 14 10 10 10 10 10 03 
03 03 03 10 10 10 10 04 04 10 10 10 03 10 10 10 14 14 14 14 10 10 10 10 03 
03 03 10 10 10 03 03 03 03 03 03 03 10 10 10 14 14 14 14 14 14 14 10 10 03 
03 03 10 10 03 10 10 10 10 04 10 10 10 10 14 14 14 14 14 14 14 14 10 10 03 
03 03 10 03 10 10 10 10 10 04 04 10 10 14 14 14 14 14 14 14 14 14 14 10 03 
03 10 03 10 10 10 10 10 10 10 04 10 10 14 14 14 14 14 14 14 14 14 14 10 03 
03 10 10 10 10 10 10 10 10 10 10 04 04 10 14 14 14 14 14 14 14 14 10 10 03 
03 10 10 10 10 10 10 10 10 10 10 04 04 10 10 14 10 14 14 14 14 14 10 10 03 
03 10 10 10 10 10 10 10 10 10 10 10 04 04 10 10 10 10 10 10 10 10 10 10 03 
03 03 03 03 03 03 03 03 03 03 03 03 03 03 03 03 03 03 03 03 03 03 03 03 03 
