13 13 13 13 13 13 13 13 13 13 05 05 05 13 13 13 13 13 13 13 13 13 13 13 13 
13 13 13 13 13 13 13 13 13 02 08 08 08 02 13 13 13 13 13 13 13 13 13 13 13 
13 13 13 13 13 13 13 13 13 13 08 08 08 13 13 13 13 13 13 13 13 13 13 13 13 
13 13 13 13 13 13 13 13 13 02 08 08 08 02 13 13 13 13 13 13 13 13 13 13 13 
13 13 13 13 13 13 13 13 13 13 05 13 13 13 13 13 13 13 13 13 13 13 13 13 13 
13 13 13 13 13 13 13 13 13 13 13 13 13 13 13 13 13 13 13 13 13 13 13 13 13 
13 13 13 13 13 13 13 13 13 13 13 13 13 13 13 13 13 13 13 13 13 13 13 13 13 
13 13 13 13 13 13 13 13 13 02 13 08 08 02 13 13 13 13 13 13 13 13 13 13 13 
13 13 02 13 02 13 02 13 02 02 05 05 05 02 02 13 02 13 02 13 02 13 02 13 02 
19 05 08 08 08 05 08 08 08 05 08 08 08 05 08 08 08 05 08 08 08 05 08 08 19 
19 05 08 08 08 05 08 08 08 05 08 08 08 05 08 08 08 05 08 08 08 05 08 08 19 
19 05 08 08 08 05 08 08 08 05 08 08 08 05 08 08 08 05 08 08 08 05 08 08 19 
13 13 02 13 02 13 02 13 02 02 05 05 05 02 02 13 02 13 02 13 02 13 02 13 02 
13 13 13 13 13 13 13 13 13 02 08 08 08 02 13 13 13 13 13 13 13 13 13 13 13 
13 13 13 13 13 13 13 13 13 13 08 08 08 13 13 13 13 13 13 13 13 13 13 13 13 
13 13 13 13 13 13 13 13 13 02 08 08 08 02 13 13 13 13 13 13 13 13 13 13 13 
13 13 13 13 13 13 13 13 13 13 05 05 05 13 13 13 13 13 13 13 13 13 13 13 13 
13 13 13 13 13 13 13 13 13 02 08 08 08 02 13 13 13 13 13 13 13 13 13 13 13 
13 13 13 13 13 13 13 13 13 13 08 08 08 13 13 13 13 13 13 13 13 13 13 13 13 
13 13 13 13 13 13 13 13 13 02 08 08 08 02 13 13 13 13 13 13 13 13 13 13 13 
13 13 13 13 13 13 13 13 13 08 08 08 08 13 13 13 13 13 13 13 13 13 13 13 13 
13 13 13 13 13 13 13 13 08 08 08 08 08 08 13 13 13 13 13 13 13 13 13 13 13 
13 13 13 13 13 13 13 13 13 08 08 08 08 13 13 13 13 13 13 13 13 13 13 13 13 
13 13 13 13 13 13 13 13 13 13 13 08 13 13 13 13 13 13 13 13 13 13 13 13 13 
13 13 13 13 13 13 13 13 13 13 13 20 13 13 13 13 13 13 13 13 13 13 13 13 13 
