05 05 05 05 05 05 05 02 13 13 13 20 13 13 13 13 13 13 02 01 01 01 01 01 01 
05 05 05 05 05 05 05 02 02 02 02 05 02 02 02 02 02 02 02 05 05 05 05 05 01 
05 05 05 05 05 05 02 02 13 05 05 05 05 05 05 02 24 05 05 05 05 05 05 05 01 
05 05 05 05 05 05 13 13 13 13 05 05 02 02 02 02 05 05 13 02 05 05 05 05 01 
05 05 05 05 02 05 05 02 13 05 13 05 05 05 05 05 05 13 13 13 02 05 05 05 01 
05 05 05 13 02 02 02 02 02 02 02 02 02 02 02 02 05 05 13 05 24 02 05 02 02 
02 02 02 13 05 02 05 05 05 05 05 05 05 05 05 02 05 05 05 05 05 02 05 02 13 
13 01 05 05 05 02 02 02 02 02 02 05 02 02 02 02 02 02 05 02 02 02 02 02 13 
13 01 05 05 13 02 12 05 05 05 05 13 05 05 05 05 12 02 05 02 05 05 05 02 13 
13 01 05 05 05 02 05 05 05 05 24 05 24 05 05 05 05 02 05 02 05 05 05 02 13 
13 02 05 05 05 02 05 05 05 24 05 05 05 24 05 05 05 02 05 02 05 05 05 02 13 
13 02 13 05 05 02 05 05 24 05 05 01 05 05 24 05 05 02 05 02 05 05 05 02 13 
05 13 13 05 05 02 05 24 05 05 05 05 05 05 05 24 05 02 05 02 05 05 05 02 13 
13 02 05 13 05 02 13 05 05 01 05 18 05 01 05 05 13 02 05 02 05 05 05 02 13 
13 02 05 05 05 02 05 24 05 05 05 05 05 05 05 24 05 02 05 02 05 05 05 02 13 
13 02 05 05 05 02 05 05 24 05 05 01 05 05 24 05 05 02 05 02 05 05 05 02 13 
13 02 13 05 05 02 05 05 05 24 05 05 05 24 05 05 05 02 05 02 05 05 05 02 13 
13 02 05 05 05 02 05 05 05 05 05 05 05 05 05 05 05 02 05 02 05 05 05 02 13 
02 02 02 05 05 02 12 02 02 05 02 13 02 05 02 02 12 02 05 02 05 05 02 02 02 
05 05 05 02 05 05 05 05 05 05 05 05 05 05 05 05 05 02 05 05 05 02 05 05 05 
05 05 05 05 02 02 02 02 02 02 05 05 05 02 02 02 02 02 05 02 02 05 05 05 05 
05 05 05 05 05 02 05 05 05 05 05 05 05 05 05 05 05 05 05 02 05 05 05 05 05 
05 05 05 05 05 05 02 05 05 05 05 05 05 05 05 05 05 02 02 05 05 05 05 05 05 
05 05 05 05 05 05 02 02 02 02 02 02 02 02 02 02 02 02 02 05 05 05 05 05 05 
05 05 05 05 05 05 02 13 13 13 13 13 13 13 13 13 13 13 02 05 05 05 05 05 05 
