03 03 03 03 03 03 03 03 03 03 03 03 20 03 03 03 03 03 01 01 01 01 01 03 03 
03 01 01 01 01 01 01 10 10 10 10 05 05 05 10 10 10 10 01 07 07 07 01 03 03 
03 01 15 07 07 07 01 10 10 10 10 05 05 05 10 10 10 10 07 07 07 07 01 03 03 
03 01 07 07 07 07 01 10 10 10 04 05 05 05 04 10 10 10 01 07 07 07 01 03 03 
03 01 07 07 07 07 01 10 10 10 10 05 05 05 04 05 10 10 01 01 01 01 01 03 03 
03 01 01 07 01 01 01 10 05 05 05 05 05 05 05 05 10 10 10 10 10 10 10 03 03 
03 10 10 10 10 10 10 10 05 05 05 05 05 05 04 05 10 10 10 10 10 10 03 03 03 
03 03 03 10 10 05 05 05 05 05 05 05 05 05 05 10 10 10 10 10 10 10 10 10 03 
03 03 03 03 10 05 05 05 05 05 05 04 10 10 10 05 10 10 10 10 10 10 10 03 03 
03 03 03 03 10 05 05 05 05 05 05 10 09 10 10 10 10 10 10 10 10 10 10 03 03 
03 03 03 03 10 05 05 05 04 10 10 05 09 05 10 10 10 10 10 10 10 10 03 10 03 
03 10 03 10 10 05 05 05 10 10 05 01 14 01 05 04 10 10 10 04 10 10 10 04 03 
03 04 10 10 05 05 05 05 10 05 01 01 09 01 01 05 04 04 10 04 04 04 04 03 03 
19 10 10 10 05 05 05 05 09 09 14 09 09 09 14 09 09 10 10 10 10 10 03 10 03 
03 10 10 10 05 10 05 05 04 05 01 01 09 01 01 05 10 10 10 10 04 10 10 10 03 
03 10 10 10 10 03 05 10 10 04 05 01 14 01 05 10 10 10 10 10 10 03 03 03 03 
03 10 03 10 03 03 03 04 04 10 10 05 09 05 10 10 10 10 10 10 10 10 10 10 03 
03 03 10 03 10 03 10 10 04 10 10 10 09 10 10 10 10 10 10 10 10 10 10 10 03 
03 10 03 03 06 06 06 10 10 04 10 10 10 10 10 10 10 10 10 10 10 03 03 03 03 
03 03 03 03 06 07 06 10 10 04 04 10 10 10 10 10 10 10 10 10 10 10 15 03 03 
03 10 03 03 06 06 06 10 10 10 04 10 10 10 10 10 10 10 10 10 10 03 03 03 03 
03 03 10 03 03 03 03 10 10 10 10 04 04 10 10 10 10 10 10 03 03 10 03 10 03 
03 10 03 03 03 03 03 03 10 10 10 04 04 10 10 10 10 10 03 03 10 03 10 03 03 
03 10 03 03 03 03 03 03 03 10 10 10 04 04 10 10 10 03 10 03 03 10 03 10 03 
03 03 03 03 03 03 03 03 03 03 03 03 03 03 03 03 03 03 03 03 03 03 03 03 03 
