03 03 03 03 03 03 03 03 03 03 03 03 03 03 03 03 03 03 03 03 03 03 03 03 03 
03 03 03 03 03 03 03 03 03 18 05 05 05 05 18 05 03 03 03 03 03 03 03 03 03 
03 03 03 03 03 03 03 03 03 05 05 18 05 05 05 05 03 03 03 03 03 03 03 03 03 
03 03 03 03 03 03 03 03 03 05 05 05 12 05 05 05 03 03 03 03 03 03 03 03 03 
03 03 03 03 03 03 03 03 03 03 05 05 05 05 05 03 03 03 03 03 03 03 03 03 03 
03 03 03 03 03 03 03 03 03 03 03 05 05 05 03 03 03 03 03 03 03 03 03 03 03 
03 03 03 03 03 03 03 03 03 03 03 03 05 03 03 03 03 03 03 03 03 03 03 03 03 
03 17 08 08 08 08 08 08 08 08 08 08 05 17 08 08 08 08 08 08 08 08 08 03 03 
19 05 05 05 05 05 05 05 05 05 05 05 05 05 05 05 05 05 05 05 05 05 05 05 19 
03 08 08 08 08 08 08 08 08 08 08 08 08 08 08 08 08 08 08 08 08 08 08 03 03 
03 08 08 03 03 03 03 03 03 03 03 03 03 03 03 03 03 03 03 03 03 03 03 03 03 
03 03 08 03 03 03 03 03 03 03 03 03 03 03 03 03 03 03 03 03 03 03 03 03 03 
03 03 08 08 08 03 03 03 03 03 03 03 03 03 03 03 08 08 08 03 03 03 03 03 03 
03 03 03 08 08 08 03 03 03 03 03 03 03 03 03 08 08 08 08 08 03 03 03 03 03 
03 03 03 08 08 08 08 03 03 03 03 03 03 03 08 08 01 01 01 08 03 03 03 03 03 
03 03 03 03 03 08 08 08 03 03 03 03 03 03 08 01 08 08 08 01 08 03 03 03 03 
03 03 03 03 03 03 08 08 08 08 03 03 03 08 08 24 08 08 08 08 01 03 03 03 03 
03 03 03 03 03 03 03 08 08 08 03 03 24 24 08 08 08 08 08 15 01 03 03 03 03 
03 03 03 03 03 03 03 03 08 08 08 08 08 08 08 01 01 08 08 08 01 03 03 03 03 
03 03 03 03 03 03 03 03 08 08 08 08 08 08 08 08 01 01 08 08 01 03 03 03 03 
03 03 03 03 03 03 03 03 03 03 03 03 03 03 03 08 08 08 01 01 08 03 03 03 03 
03 03 03 03 03 03 03 03 03 03 03 03 03 03 03 03 03 08 08 03 03 03 03 03 03 
03 03 03 03 03 03 03 03 03 03 03 03 03 03 03 03 03 03 03 03 03 03 03 03 03 
03 03 03 03 03 03 03 03 03 03 03 03 03 03 03 03 03 03 03 03 03 03 03 03 03 
03 03 03 03 03 03 03 03 03 03 03 03 03 03 03 03 03 03 03 03 03 03 03 03 03 
