13 13 13 13 13 13 13 13 13 13 13 13 13 13 13 13 13 13 13 13 13 13 13 13 13 
13 13 13 13 13 13 13 13 13 13 13 13 13 13 13 13 13 13 13 13 13 13 13 13 13 
13 13 13 13 13 13 13 13 13 13 13 13 13 13 13 13 13 13 13 13 13 13 13 13 13 
13 13 13 13 13 13 13 13 13 13 13 13 13 13 13 13 13 13 13 13 13 13 13 13 13 
13 13 13 13 13 13 13 13 13 13 13 13 13 13 13 13 13 13 13 13 13 13 13 13 13 
13 13 13 13 13 13 13 13 13 13 13 13 13 13 13 13 13 13 13 13 13 13 13 13 13 
13 13 13 13 13 13 13 13 13 13 13 13 13 13 13 13 13 13 13 13 13 13 13 13 13 
13 13 13 13 13 13 13 13 13 13 13 13 13 08 13 13 13 13 13 13 13 13 13 13 13 
13 13 13 13 13 13 13 13 13 13 13 13 08 08 08 08 13 13 13 13 13 13 13 13 13 
19 05 05 05 05 05 05 05 05 05 05 08 08 08 08 08 08 13 13 13 13 13 13 13 13 
19 05 05 05 05 05 05 05 05 05 08 08 08 08 08 08 08 08 08 08 13 13 13 13 13 
19 05 05 05 05 05 05 05 05 08 08 08 08 08 08 08 08 08 08 13 13 13 13 13 13 
13 13 13 13 13 13 13 13 08 08 08 08 02 05 05 05 02 08 08 08 13 13 13 13 13 
13 13 13 13 13 13 13 13 08 08 08 08 05 05 14 05 05 08 08 08 08 13 13 13 13 
13 13 13 13 13 13 13 13 13 08 08 08 05 14 14 14 05 08 08 08 08 08 13 13 13 
13 13 13 13 13 13 13 13 13 13 08 08 05 05 14 05 05 08 08 08 08 13 13 13 13 
13 13 13 13 13 13 13 13 13 08 08 08 02 05 05 05 02 08 08 08 13 13 13 13 13 
13 13 13 13 13 13 13 13 13 08 08 08 08 08 08 08 08 08 08 13 13 13 13 13 13 
13 13 13 13 13 13 13 13 13 08 08 08 08 08 08 08 08 08 08 13 13 13 13 13 13 
13 13 13 13 13 13 13 13 13 13 08 08 08 08 08 08 08 08 08 13 13 13 13 13 13 
13 13 13 13 13 13 13 13 13 13 13 08 08 08 08 08 08 08 08 08 13 13 13 13 13 
13 13 13 13 13 13 13 13 13 13 13 08 08 08 08 08 08 08 08 08 13 13 13 13 13 
13 13 13 13 13 13 13 13 13 13 13 13 08 08 08 08 08 08 08 13 13 13 13 13 13 
13 13 13 13 13 13 13 13 13 13 13 13 13 08 08 08 08 13 13 13 13 13 13 13 13 
13 13 13 13 13 13 13 13 13 13 13 13 13 13 20 13 13 13 13 13 13 13 13 13 13 
