13 13 13 13 13 13 13 13 02 02 02 02 02 02 20 02 02 02 13 13 13 13 13 13 13 
13 13 13 13 13 13 15 08 02 08 10 08 10 08 10 08 10 02 08 08 13 13 13 13 13 
13 13 13 13 13 13 08 08 02 10 08 10 08 10 08 10 08 02 08 08 13 13 13 13 13 
13 13 13 13 13 13 08 08 02 08 10 08 10 08 10 08 10 02 08 08 13 13 13 13 13 
13 13 13 13 13 13 08 08 02 10 08 10 08 10 08 10 08 02 08 08 13 13 13 13 13 
13 13 13 13 13 13 08 08 02 08 10 08 10 08 10 08 10 02 08 08 13 13 13 13 13 
13 13 13 13 13 13 08 08 02 10 08 10 08 10 08 10 08 02 08 08 13 13 13 13 13 
13 13 13 13 13 13 08 08 02 08 10 08 10 08 10 08 10 02 08 08 08 08 08 08 19 
13 13 13 13 13 13 08 08 02 10 08 10 08 10 08 10 08 02 08 08 08 08 08 08 19 
13 13 13 13 13 13 08 08 02 02 02 02 08 08 08 02 02 02 08 08 08 08 08 08 19 
13 13 13 13 13 13 13 08 08 08 08 08 08 08 08 08 08 08 08 13 13 13 13 13 13 
13 13 13 13 13 13 13 13 08 08 08 08 08 08 08 08 08 08 13 13 13 13 13 13 13 
13 13 13 13 13 13 13 13 13 08 08 08 08 08 08 08 08 13 13 13 13 13 13 13 13 
13 13 13 13 13 13 13 13 13 13 13 13 13 13 13 13 13 13 13 13 13 13 13 13 13 
13 13 13 13 13 13 13 13 13 13 13 13 13 13 13 13 13 13 13 13 13 13 13 13 13 
13 13 13 13 13 13 13 13 13 13 13 13 13 13 13 13 13 13 13 13 13 13 13 13 13 
13 13 13 13 13 13 13 13 13 13 13 13 13 13 13 13 13 13 13 13 13 13 13 13 13 
13 13 13 13 13 13 13 13 13 13 13 13 13 13 13 13 13 13 13 13 13 13 13 13 13 
13 13 13 13 13 13 13 13 13 13 13 13 13 13 13 13 13 13 13 13 13 13 13 13 13 
13 13 13 13 13 13 13 13 13 13 13 13 13 13 13 13 13 13 13 13 13 13 13 13 13 
13 13 13 13 13 13 13 13 13 13 13 13 13 13 13 13 13 13 13 13 13 13 13 13 13 
13 13 13 13 13 13 13 13 13 13 13 13 13 13 13 13 13 13 13 13 13 13 13 13 13 
13 13 13 13 13 13 13 13 13 13 13 13 13 13 13 13 13 13 13 13 13 13 13 13 13 
13 13 13 13 13 13 13 13 13 13 13 13 13 13 13 13 13 13 13 13 13 13 13 13 13 
13 13 13 13 13 13 13 13 13 13 13 13 13 13 13 13 13 13 13 13 13 13 13 13 13 
