03 03 03 03 03 03 03 03 03 03 03 03 20 03 03 03 03 03 03 03 03 03 03 03 03 
03 03 03 03 03 03 03 03 03 08 08 08 05 08 08 08 03 03 03 03 03 03 03 03 03 
03 03 03 03 03 03 03 08 08 08 08 08 05 08 08 08 03 03 03 03 03 03 03 03 03 
03 03 03 03 03 03 08 08 08 08 08 08 05 08 08 08 08 08 03 03 03 03 03 03 03 
03 03 03 03 03 08 08 08 08 08 08 08 05 17 08 08 08 08 08 03 03 03 03 03 03 
03 03 03 03 08 08 08 08 08 08 08 08 05 08 08 08 08 08 08 08 03 03 03 03 03 
03 03 03 08 08 08 08 08 08 08 08 08 05 08 08 08 08 08 08 08 08 08 03 03 03 
03 08 08 08 08 08 08 08 08 08 08 03 05 03 08 08 08 08 03 08 08 08 08 03 03 
19 05 05 05 05 05 05 05 05 05 05 05 05 03 08 08 08 03 03 08 08 08 08 08 03 
03 08 08 08 08 08 08 08 08 08 08 03 05 03 08 08 08 08 03 08 08 08 08 03 03 
03 08 08 08 08 08 08 08 08 08 03 08 05 08 08 08 08 08 08 08 08 08 03 03 03 
03 03 08 08 08 03 08 03 03 03 08 08 05 08 08 08 08 08 08 08 08 08 08 03 03 
03 03 08 08 08 08 08 03 03 03 08 03 05 05 05 05 05 05 05 05 05 05 05 05 19 
03 03 03 08 08 08 03 08 03 03 03 03 03 03 08 08 08 08 08 08 03 03 03 03 03 
03 03 03 08 08 08 08 03 03 03 08 03 03 08 08 08 08 03 08 08 03 03 03 03 03 
03 03 03 03 03 08 08 08 03 03 03 03 08 08 08 08 08 08 08 08 08 03 03 03 03 
03 03 03 03 03 03 08 08 08 08 08 08 08 08 03 08 08 08 08 08 08 03 03 03 03 
03 03 03 03 03 03 03 08 08 08 08 08 08 08 08 08 03 08 08 08 08 03 03 03 03 
03 03 03 03 03 03 03 03 08 08 08 08 08 08 08 08 08 08 08 08 03 03 03 03 03 
03 03 03 03 03 03 03 03 08 08 08 08 08 08 08 08 08 08 08 08 08 03 03 03 03 
03 03 03 03 03 03 03 03 03 03 03 03 03 03 03 08 08 03 08 08 08 03 03 03 03 
03 03 03 03 03 03 03 03 03 03 03 03 03 03 03 03 03 08 08 03 03 03 03 03 03 
03 03 03 03 03 03 03 03 03 03 03 03 03 03 03 03 03 03 03 03 03 03 03 03 03 
03 03 03 03 03 03 03 03 03 03 03 03 03 03 03 03 03 03 03 03 03 03 03 03 03 
03 03 03 03 03 03 03 03 03 03 03 03 03 03 03 03 03 03 03 03 03 03 03 03 03 
