03 03 03 03 03 03 03 03 03 03 03 03 03 03 02 24 05 07 07 05 05 02 13 13 13 
03 03 03 03 03 03 03 03 03 03 03 03 03 03 02 05 05 07 07 24 05 02 13 13 13 
03 10 03 03 03 03 03 03 03 03 03 03 03 03 03 02 05 05 05 05 02 05 24 13 13 
03 10 03 03 03 03 03 03 03 03 03 03 03 03 03 03 02 05 05 02 03 03 05 05 13 
03 10 10 03 03 03 03 03 03 03 03 03 03 03 03 03 03 02 02 03 03 03 03 05 05 
03 10 10 03 03 03 03 03 03 03 03 03 03 03 03 03 03 03 03 03 03 03 03 03 03 
03 10 04 03 03 03 03 03 03 03 03 03 03 03 03 03 03 03 03 03 03 03 03 03 03 
03 10 04 04 03 03 03 03 14 14 03 03 03 03 03 03 03 03 08 08 08 03 03 03 03 
03 10 04 03 03 03 14 14 14 03 03 03 03 03 03 03 03 08 08 08 08 08 08 08 03 
03 10 04 03 14 14 14 14 14 14 14 03 03 03 03 03 08 08 03 08 08 08 08 08 19 
03 10 03 14 14 14 14 14 14 14 14 14 03 03 03 08 08 08 03 03 08 08 08 08 03 
03 03 03 12 01 12 01 12 01 12 01 12 03 08 08 08 08 08 08 03 08 08 08 08 03 
19 05 05 05 05 05 05 05 05 05 05 05 08 08 08 08 03 03 08 08 03 08 08 08 03 
03 03 04 12 01 12 01 12 01 12 01 12 03 03 03 03 08 08 03 08 08 03 08 08 03 
03 04 04 14 14 14 14 14 14 14 14 14 03 03 08 08 08 08 08 03 08 08 08 08 03 
03 10 04 04 14 14 14 14 14 14 14 03 03 08 08 08 03 03 08 08 08 08 03 03 03 
03 03 03 03 03 14 14 08 08 14 03 08 08 08 08 03 03 03 03 08 08 03 03 03 03 
03 09 09 09 03 03 08 08 08 08 08 08 08 03 03 03 03 03 03 03 03 03 03 03 03 
03 09 09 09 14 08 08 08 08 08 08 03 03 03 03 03 03 03 03 03 03 03 03 03 03 
03 03 09 14 14 08 08 03 03 03 03 03 03 03 03 03 03 03 03 03 03 03 03 03 03 
03 03 03 14 09 09 03 03 03 03 03 03 03 03 03 03 03 03 03 03 03 03 03 03 03 
03 03 03 03 09 03 03 03 03 03 03 03 03 03 03 03 03 03 03 03 03 03 03 03 03 
03 03 03 03 03 03 03 03 03 03 03 03 03 03 03 03 03 03 03 03 03 03 03 03 03 
03 03 03 03 03 03 03 03 03 03 03 03 03 03 03 03 03 03 03 03 03 03 03 03 03 
03 03 03 03 03 03 03 03 03 03 03 03 03 03 03 03 03 03 03 03 03 03 03 03 03 
