05 05 05 05 05 05 05 13 13 13 13 13 01 01 01 01 01 01 01 01 01 01 01 13 13 
05 05 05 05 05 05 13 13 13 13 13 13 01 08 08 08 08 08 08 08 08 08 01 13 13 
05 05 05 13 13 13 13 13 13 13 13 13 01 08 08 08 08 08 08 08 08 08 01 13 13 
05 05 13 13 13 13 13 13 13 13 13 13 01 08 08 08 08 08 08 08 08 08 01 13 13 
13 13 13 13 13 13 13 13 13 13 13 13 01 08 08 08 13 13 13 08 08 08 01 13 13 
13 13 13 13 13 13 13 13 13 13 13 13 01 08 08 08 13 12 13 08 08 08 01 13 13 
13 13 13 13 13 13 13 13 13 13 13 13 01 08 08 08 13 13 13 08 08 08 01 13 13 
13 13 13 13 13 13 13 13 13 13 13 13 01 08 08 08 08 08 08 08 08 08 01 13 13 
13 13 13 13 13 13 13 13 13 13 13 13 01 08 08 08 08 08 08 08 08 08 01 13 13 
13 13 13 13 13 13 13 13 08 08 13 13 01 08 08 08 08 08 08 08 08 08 01 13 13 
13 13 13 13 13 13 13 08 13 08 08 05 01 01 01 01 08 08 08 01 01 01 01 13 13 
13 13 13 13 13 13 08 13 13 13 08 08 01 24 05 01 08 08 08 01 05 05 01 13 13 
13 13 13 13 13 13 05 08 13 13 08 08 01 05 05 01 08 08 08 01 18 05 01 13 13 
13 13 13 13 13 13 13 08 05 13 08 13 01 05 05 02 08 08 08 02 05 24 01 13 13 
13 13 13 13 13 13 13 05 08 08 13 13 01 05 05 02 08 08 08 02 05 05 01 13 13 
13 13 13 13 13 13 13 13 13 13 13 13 01 05 05 01 08 08 08 01 05 24 01 13 13 
13 13 13 13 13 13 13 13 13 13 13 13 01 05 05 01 08 08 08 01 05 05 01 13 13 
13 13 13 13 13 13 13 13 13 13 13 13 01 01 01 01 08 08 08 01 01 01 01 13 13 
13 13 13 13 13 13 13 13 13 13 13 13 01 18 05 01 08 08 08 01 24 05 01 13 13 
13 13 13 13 13 13 13 13 13 13 13 13 01 05 05 01 08 08 08 01 05 05 01 13 13 
13 13 13 13 13 13 13 13 13 13 13 13 01 05 05 02 08 08 08 02 05 24 01 13 13 
13 13 13 13 13 13 13 13 13 13 13 13 01 05 18 02 08 08 08 02 05 05 01 13 13 
13 13 13 13 13 13 13 13 13 13 13 13 01 05 05 01 08 08 08 01 05 05 01 13 13 
13 13 13 13 13 13 13 13 13 13 13 13 01 05 05 01 08 08 08 01 05 05 01 13 13 
13 13 13 13 13 13 13 13 13 13 13 13 01 01 01 01 20 20 20 01 01 01 01 13 13 
