03 03 03 03 03 03 03 03 03 03 03 03 03 03 03 03 03 03 03 03 03 03 03 03 03 
19 08 08 03 03 03 03 03 03 03 03 03 03 03 03 03 03 03 03 03 03 03 03 03 03 
03 08 08 08 08 08 03 08 03 03 03 03 03 03 03 03 03 03 03 03 03 03 03 03 03 
03 03 08 08 03 08 08 08 08 08 03 08 03 03 03 03 03 03 03 03 03 03 03 03 03 
03 08 08 03 03 08 03 08 08 05 05 05 05 05 05 03 03 03 03 03 08 03 03 03 03 
03 08 03 08 08 08 08 03 08 03 08 03 03 03 05 05 08 08 08 08 08 08 03 03 03 
03 08 08 08 03 08 03 03 03 03 03 03 03 03 03 03 08 08 03 03 08 08 03 03 03 
03 03 08 08 03 03 03 03 03 03 03 08 08 03 03 03 03 08 08 03 08 08 08 03 03 
03 03 03 03 03 03 03 03 03 03 08 08 08 08 03 03 03 03 03 08 08 08 03 03 03 
03 03 03 03 03 03 03 03 03 08 08 08 03 08 08 03 03 08 08 03 08 08 08 03 03 
03 03 03 03 03 03 03 03 03 01 05 05 01 08 08 03 08 08 08 08 03 08 08 03 03 
03 03 03 03 03 03 03 03 01 05 05 05 01 08 08 08 08 08 03 08 08 08 08 03 03 
03 03 03 03 03 03 03 01 05 05 05 01 03 08 08 08 08 03 08 08 08 08 03 03 03 
03 03 03 03 03 03 03 01 05 05 01 03 03 03 08 08 03 03 03 08 08 03 03 03 03 
03 03 03 03 03 03 03 01 05 05 05 01 03 03 03 03 03 03 03 03 03 03 03 03 03 
03 03 03 03 03 03 03 03 01 05 01 03 03 03 03 03 03 03 03 03 03 03 03 03 03 
03 03 03 03 03 03 03 01 05 05 05 01 03 03 03 03 06 08 08 08 06 06 03 03 03 
03 03 03 03 03 03 03 03 01 05 08 08 03 03 03 08 08 03 14 08 06 06 06 03 03 
03 03 03 03 03 03 03 03 03 03 08 08 08 03 08 08 08 14 14 03 14 08 06 08 03 
03 03 02 02 03 03 03 03 05 05 05 08 08 08 06 06 14 14 14 14 14 14 06 06 19 
03 02 18 07 02 03 03 03 05 05 05 03 03 08 03 03 03 14 14 14 14 14 14 03 03 
02 07 07 07 07 02 05 05 05 05 03 03 03 03 03 03 03 03 14 14 14 03 03 03 03 
02 07 07 07 07 02 05 05 05 05 03 03 03 03 03 03 03 03 14 03 03 03 03 03 03 
03 02 07 07 02 03 03 03 03 03 03 03 03 03 03 03 03 03 03 03 03 03 03 03 03 
03 03 02 02 03 03 03 03 03 03 03 03 03 03 03 03 03 03 03 03 03 03 03 03 03 
