03 03 03 03 03 03 03 03 03 03 03 03 03 03 03 03 03 03 03 03 03 03 03 03 03 
03 08 08 08 03 03 03 08 08 08 08 08 08 08 08 08 08 08 08 08 08 08 08 08 19 
03 08 03 08 03 03 03 08 03 03 03 03 08 03 03 03 03 03 03 03 03 03 03 03 03 
03 08 03 08 03 03 03 08 03 03 03 03 08 08 08 08 08 08 08 03 03 03 03 03 03 
03 08 03 08 03 03 03 08 03 03 03 03 08 03 03 03 03 03 08 03 03 03 03 03 03 
03 08 03 08 03 08 08 08 08 08 08 03 08 03 03 03 03 03 08 03 03 03 03 03 03 
03 08 03 08 03 08 03 08 03 03 08 03 08 08 08 08 03 03 08 03 03 03 03 03 03 
03 08 03 08 03 08 03 08 03 03 08 03 03 03 03 08 03 03 08 03 03 03 03 03 03 
03 08 03 08 03 08 08 08 03 08 08 08 08 03 03 08 08 03 08 03 03 03 03 03 03 
03 08 03 08 03 03 03 03 03 03 03 03 08 03 03 03 08 03 08 03 03 03 03 03 03 
03 08 03 08 03 03 08 08 08 08 08 08 08 08 08 03 08 03 08 03 03 03 03 03 03 
03 08 03 08 03 03 08 03 03 03 03 03 03 03 08 03 08 03 08 03 08 08 08 03 03 
19 08 03 08 03 08 08 08 08 08 08 08 03 03 08 03 08 03 08 08 08 03 08 08 19 
03 08 03 08 03 03 03 03 03 03 03 08 03 03 08 08 08 08 08 03 03 03 08 03 03 
03 08 03 08 03 03 03 03 03 03 03 08 03 08 03 03 08 03 03 03 03 03 08 03 03 
03 08 08 03 03 03 08 08 08 08 08 08 08 03 03 03 08 03 03 03 03 03 08 03 03 
03 03 08 08 08 08 08 03 03 03 03 08 03 08 08 08 08 03 03 03 03 03 08 03 03 
03 03 03 03 03 03 03 03 03 03 03 08 03 08 03 03 03 03 03 03 03 03 08 03 03 
03 03 03 03 03 08 08 08 08 08 08 08 03 08 03 03 03 03 03 03 08 08 08 03 03 
03 03 03 03 08 03 03 03 03 03 03 03 03 08 03 03 03 03 03 08 08 03 03 03 03 
03 03 03 08 03 03 03 03 03 03 03 03 03 08 03 08 08 08 08 08 03 03 03 03 03 
03 03 08 03 03 03 03 03 03 03 03 03 03 08 03 08 03 03 03 08 08 03 03 03 03 
03 03 08 08 08 08 08 08 08 08 08 08 08 08 08 08 03 03 03 03 08 08 03 03 03 
03 03 08 03 03 03 03 03 03 03 03 03 03 03 03 03 03 03 03 03 03 08 03 03 03 
03 03 20 03 03 03 03 03 03 03 03 03 03 03 03 03 03 03 03 03 03 20 03 03 03 
