13 13 13 13 13 13 13 13 13 08 08 03 03 03 03 03 08 05 05 14 14 14 14 14 14 
13 13 13 13 13 13 13 13 13 13 08 08 08 03 08 08 13 13 05 05 14 14 14 14 14 
13 13 13 13 13 02 02 02 13 13 13 13 08 08 13 13 13 13 13 05 05 14 14 14 14 
13 13 13 13 02 05 08 05 02 13 13 13 13 13 13 13 13 13 13 13 05 05 14 14 14 
13 13 13 02 05 05 08 05 05 02 13 13 13 13 13 13 13 13 13 13 13 05 05 14 14 
13 13 02 05 05 05 08 05 05 05 02 13 13 13 13 13 13 13 13 13 13 13 05 05 14 
02 02 05 05 05 05 08 05 05 05 05 02 13 13 13 13 13 02 05 02 05 02 13 05 05 
19 05 05 05 05 01 01 01 05 05 05 05 02 08 08 08 08 05 05 05 05 05 13 13 13 
19 08 08 08 08 01 08 01 08 08 08 08 05 08 08 08 08 02 05 12 05 02 13 13 13 
19 05 05 05 05 01 01 01 05 05 05 05 02 08 08 08 08 05 05 05 05 05 13 13 13 
02 02 05 05 05 05 08 05 05 05 05 02 13 13 13 13 13 02 05 02 05 02 13 13 13 
13 13 02 05 05 05 08 05 05 05 02 13 13 13 13 13 13 13 08 08 08 13 13 13 13 
13 13 13 02 05 05 08 05 05 02 13 13 13 13 13 13 13 13 08 08 08 13 13 13 13 
13 13 13 13 02 05 08 05 02 13 13 13 13 13 13 13 13 13 08 08 08 13 13 13 13 
13 13 13 13 13 02 02 02 13 13 13 13 13 13 13 13 13 13 08 08 08 13 13 13 13 
13 13 13 13 13 13 13 13 02 05 02 05 02 13 13 13 13 02 05 02 05 02 13 13 13 
13 13 13 13 13 13 13 13 05 05 05 05 05 08 08 08 08 05 05 05 05 05 13 13 13 
13 13 13 13 13 13 13 13 15 05 12 05 02 08 08 08 08 02 05 12 05 02 13 13 13 
13 13 13 13 13 13 13 13 05 05 05 05 05 08 08 08 08 05 05 05 05 05 13 13 13 
13 13 13 13 13 13 13 13 02 05 02 05 02 13 13 13 13 02 05 02 05 02 13 13 13 
13 13 13 13 13 13 13 13 13 13 13 13 13 13 13 13 13 13 13 13 13 13 13 13 13 
13 13 13 13 13 13 13 13 13 13 13 13 13 13 13 13 13 13 13 13 13 13 13 13 13 
13 13 13 13 13 13 13 13 13 13 13 13 13 13 13 13 13 13 13 13 13 13 13 13 13 
13 13 13 13 13 13 13 13 13 13 13 13 13 13 13 13 13 13 13 13 13 13 13 13 13 
13 13 13 13 13 13 13 13 13 13 13 13 13 13 13 13 13 13 13 13 13 13 13 13 13 
