03 03 03 03 03 03 03 03 03 03 03 03 03 03 03 03 03 03 03 03 03 03 03 03 03 
03 03 03 03 03 03 03 03 03 03 03 03 03 03 03 03 03 03 03 03 03 03 03 03 03 
03 03 03 03 03 03 03 03 03 03 03 03 03 03 03 03 03 03 03 03 03 03 03 03 03 
03 03 03 03 03 03 03 03 03 03 03 03 03 03 03 03 03 03 03 03 03 03 03 03 03 
03 03 03 03 03 03 03 03 03 03 03 03 18 08 11 03 03 03 03 03 03 03 03 03 03 
03 03 03 03 03 03 03 03 03 03 03 08 08 08 08 18 03 03 03 03 03 03 03 03 03 
03 03 03 03 03 03 03 03 03 03 08 08 08 08 08 08 08 03 03 03 03 03 03 03 03 
03 03 03 03 03 08 03 03 03 03 08 08 08 08 12 08 08 08 03 03 03 03 03 03 03 
03 03 03 03 08 08 08 08 03 08 08 08 08 08 08 08 08 08 08 03 03 03 03 03 03 
03 03 03 08 08 08 08 08 08 08 08 08 08 08 08 08 08 08 08 08 08 08 03 03 03 
03 03 03 08 08 08 08 08 08 08 03 03 08 18 08 08 08 03 08 08 08 08 03 03 03 
03 03 03 08 08 08 08 08 08 08 03 03 03 08 08 08 03 03 03 03 08 08 08 05 19 
03 03 03 03 03 08 08 08 08 03 03 03 03 03 03 03 03 03 03 03 08 08 03 08 03 
03 03 03 03 03 03 08 08 08 03 14 14 14 14 14 03 03 03 03 08 08 08 03 08 03 
03 03 03 03 03 03 08 08 03 03 14 14 14 14 03 03 03 03 08 08 08 03 08 08 03 
03 03 03 03 03 03 08 08 03 03 03 03 14 03 08 08 08 03 08 08 03 03 08 08 03 
03 03 03 03 03 08 08 08 08 08 03 03 03 08 08 14 08 03 08 08 03 08 08 03 03 
03 03 03 08 08 08 03 03 08 08 08 08 08 08 14 14 08 08 08 03 03 08 03 03 03 
03 08 08 08 08 08 08 03 03 03 08 08 08 03 14 14 08 08 08 03 08 08 03 03 03 
19 08 08 03 03 08 08 08 08 08 03 03 03 14 14 03 03 03 03 08 08 03 03 03 03 
03 03 08 08 08 08 08 08 08 08 08 08 14 14 03 08 08 03 08 08 08 03 03 03 03 
03 03 03 08 08 08 08 03 03 08 03 14 14 14 14 08 08 08 08 03 03 03 03 03 03 
03 03 03 03 08 03 03 03 03 03 14 14 14 14 14 14 03 03 03 03 03 03 03 03 03 
03 03 03 03 03 03 03 03 03 03 03 03 14 14 14 03 03 03 03 03 03 03 03 03 03 
03 03 03 03 03 03 03 03 03 03 03 03 14 03 03 03 03 03 03 03 03 03 03 03 03 
