03 03 03 03 03 03 03 03 03 03 14 14 14 03 03 03 03 03 03 03 03 03 03 03 03 
03 03 03 03 03 03 03 03 03 14 14 14 03 03 03 03 03 03 03 03 03 03 03 03 03 
03 03 03 03 03 03 03 03 14 14 14 03 03 03 03 03 03 03 03 03 03 03 03 03 03 
03 03 03 03 03 03 03 03 14 14 03 03 03 03 03 03 03 03 03 03 03 03 03 03 03 
03 03 03 03 03 03 03 14 14 14 14 03 03 03 03 03 03 03 03 03 03 03 03 03 03 
03 03 03 03 03 03 03 14 14 14 14 14 14 14 14 14 14 03 03 03 03 03 03 03 03 
03 03 03 03 03 03 03 03 14 14 14 14 14 14 14 14 14 14 14 14 03 03 03 03 03 
03 03 03 03 03 03 03 03 03 03 14 14 14 14 14 14 14 14 14 14 14 14 14 14 14 
03 03 03 03 03 03 03 03 03 03 14 14 14 14 14 07 07 07 07 14 14 14 14 14 03 
03 03 03 03 03 03 03 03 03 03 03 03 03 03 03 03 02 02 03 14 14 14 03 03 03 
03 03 03 03 03 03 03 03 03 03 03 03 03 03 03 03 02 02 03 03 03 03 03 03 03 
03 03 03 03 03 03 03 08 08 08 03 03 03 03 03 01 05 05 01 03 03 03 03 03 03 
03 03 03 03 03 03 08 08 03 08 03 03 03 03 01 07 05 05 07 01 03 03 03 03 03 
03 03 03 03 03 08 08 03 03 08 08 03 03 01 07 07 02 02 07 07 01 03 03 03 03 
03 03 03 03 03 08 08 03 03 03 08 08 03 01 07 07 02 02 07 07 08 08 03 03 03 
03 03 03 03 08 08 08 03 03 03 08 08 08 03 01 07 07 07 07 01 03 08 03 03 03 
03 03 03 08 08 08 03 03 03 03 03 08 08 03 03 01 07 07 01 03 03 08 03 03 03 
03 03 03 03 08 08 03 03 03 03 03 08 08 03 03 03 08 01 03 03 03 08 03 03 03 
03 03 03 03 03 08 08 03 03 03 03 03 08 08 03 08 08 03 03 03 03 08 03 03 03 
03 03 03 03 03 03 08 08 03 03 03 03 03 08 08 08 03 03 03 03 03 08 03 03 03 
03 03 03 03 03 03 03 08 08 08 03 03 03 03 03 03 03 03 03 03 03 08 03 03 03 
03 03 03 03 03 03 03 03 03 08 08 03 03 03 03 03 03 03 03 03 03 08 08 03 03 
03 03 03 03 03 03 03 03 03 03 08 03 03 03 03 03 03 03 03 03 03 03 08 08 19 
03 03 03 03 03 03 03 03 03 03 08 03 03 03 03 03 03 03 03 03 03 03 03 03 03 
03 03 03 03 03 03 03 03 03 03 20 03 03 03 03 03 03 03 03 03 03 03 03 03 03 
