14 14 14 14 14 14 14 03 03 03 03 03 20 03 03 03 03 03 14 14 14 14 14 14 14 
14 14 14 14 14 14 14 14 14 14 14 14 07 14 14 14 14 14 14 14 14 14 14 14 14 
14 14 14 14 14 14 14 14 14 14 14 07 07 07 14 14 14 14 14 14 14 14 14 14 14 
14 14 02 02 02 14 14 14 14 14 14 07 07 07 14 14 14 14 14 14 02 02 02 14 14 
14 02 07 07 07 02 14 14 14 14 14 07 07 07 14 14 14 14 14 02 07 07 07 02 14 
02 07 07 07 07 07 02 14 14 14 14 07 07 07 14 14 14 14 02 07 07 07 07 07 02 
02 07 07 07 07 07 02 02 02 02 02 05 05 05 02 02 02 02 02 07 07 21 07 07 02 
02 07 07 07 07 07 02 00 00 00 00 05 05 05 00 00 00 00 02 07 07 07 07 07 02 
14 02 07 07 07 02 00 06 06 16 00 05 05 05 00 18 06 00 03 02 07 07 07 02 14 
14 14 02 02 02 00 06 06 06 06 00 05 05 05 00 06 06 00 03 03 08 02 02 14 14 
14 14 14 02 00 18 06 06 06 06 06 05 05 05 06 06 06 06 08 08 08 02 14 14 14 
14 14 14 02 00 06 06 06 06 06 00 05 05 05 00 00 00 00 03 03 03 02 14 14 14 
14 14 14 02 00 00 00 00 00 00 00 05 05 05 03 05 05 05 05 05 03 02 14 14 14 
14 14 14 02 05 05 05 05 05 05 05 05 05 05 03 05 14 14 14 05 03 02 14 14 14 
14 14 14 02 05 00 00 00 00 00 00 05 05 05 05 05 14 14 14 05 03 02 14 14 14 
14 14 14 02 05 00 15 08 07 07 00 05 05 05 03 05 14 14 14 05 03 02 14 14 14 
14 14 14 02 05 00 08 08 07 08 00 05 05 05 03 05 05 05 05 05 03 02 14 14 14 
14 14 14 02 05 00 08 07 08 07 00 05 05 05 03 03 03 03 03 03 03 02 14 14 14 
14 14 14 02 05 00 07 07 08 08 07 05 05 05 03 03 03 03 03 03 03 02 14 14 14 
14 14 14 02 05 00 00 00 00 00 00 05 05 05 03 03 03 03 03 03 03 02 14 14 14 
14 14 14 02 05 05 05 05 05 05 05 05 05 05 03 03 05 05 05 03 03 02 14 14 14 
14 14 14 02 03 03 03 03 03 03 03 05 05 05 05 05 05 18 05 03 03 02 14 14 14 
14 14 14 02 03 03 03 03 03 03 03 05 05 05 03 03 05 05 05 03 03 02 14 14 14 
14 14 14 02 03 03 03 03 03 03 03 05 05 05 03 03 03 03 03 03 03 02 14 14 14 
14 14 14 02 02 02 02 02 02 02 02 20 20 20 02 02 02 02 02 02 02 02 14 14 14 
