14 14 14 02 02 02 02 02 02 02 02 20 20 20 02 02 02 02 02 02 02 02 14 14 14 
14 14 14 02 03 03 03 03 03 03 03 05 05 05 00 00 00 00 00 00 00 02 14 14 14 
14 14 14 02 03 05 05 08 05 08 03 05 05 05 00 18 06 00 06 06 00 02 14 14 14 
14 14 14 02 03 08 14 14 14 05 03 05 05 05 00 06 06 00 06 06 00 02 14 14 14 
14 14 14 02 03 05 15 11 14 05 05 05 05 05 00 06 00 00 00 06 00 02 14 14 14 
14 14 14 02 03 08 14 14 14 05 03 05 05 05 06 06 06 06 06 06 00 02 14 14 14 
14 14 14 02 03 05 05 08 05 08 03 05 05 05 00 00 00 00 00 06 00 02 14 14 14 
14 14 14 02 03 03 03 03 03 03 03 05 05 05 00 18 06 06 06 06 00 02 14 14 14 
14 14 14 02 03 00 00 00 00 00 00 05 05 05 00 06 06 00 00 06 00 02 14 14 14 
14 14 14 02 03 00 07 07 07 07 07 05 05 05 00 06 06 00 06 06 00 02 14 14 14 
14 14 14 02 08 07 07 07 07 00 00 05 05 05 00 00 00 00 00 00 00 02 14 14 14 
14 14 14 02 08 00 07 07 07 00 08 05 05 05 08 03 03 03 03 03 03 02 14 14 14 
14 14 14 02 08 00 00 00 00 00 08 05 05 05 08 03 03 03 03 03 03 02 14 14 14 
14 14 14 02 08 08 08 08 15 03 08 05 05 05 08 03 03 03 03 03 03 02 14 14 14 
14 14 14 02 03 08 08 08 08 03 08 05 05 05 08 03 03 03 03 03 03 02 14 14 14 
14 14 02 02 02 03 08 08 08 03 08 05 05 05 08 03 03 03 03 03 02 02 02 14 14 
14 02 07 07 07 02 03 08 08 03 08 05 05 05 08 03 03 03 03 02 07 07 07 02 14 
02 07 07 07 07 07 02 03 03 03 08 05 05 05 08 03 03 03 02 07 07 07 07 07 02 
02 07 07 07 07 07 02 02 02 02 02 05 05 05 02 02 02 02 02 07 07 07 07 07 02 
02 07 07 07 07 07 02 14 14 14 14 07 07 07 14 14 14 14 02 07 07 07 07 07 02 
14 02 07 07 07 02 14 14 14 14 14 07 07 07 14 14 14 14 14 02 07 07 07 02 14 
14 14 02 02 02 14 14 14 14 14 14 07 07 07 14 14 14 14 14 14 02 02 02 14 14 
14 14 14 14 14 14 14 14 14 14 14 07 07 07 14 14 14 14 14 14 14 14 14 14 14 
14 14 14 14 14 14 14 14 14 14 14 14 07 14 14 14 14 14 14 14 14 14 14 14 14 
14 14 14 14 14 03 03 03 03 03 03 03 20 03 03 03 03 03 03 03 03 14 14 14 14 
