03 03 03 03 03 03 03 03 03 03 03 03 20 03 03 03 03 03 03 03 03 03 03 03 03 
03 03 03 03 03 03 03 03 03 03 03 03 08 03 03 03 03 03 03 03 03 03 03 03 03 
03 03 03 03 03 03 03 03 03 03 11 08 08 03 03 08 08 08 08 03 03 03 03 03 14 
03 03 03 03 03 03 03 03 08 08 08 08 03 03 08 08 08 08 08 08 03 03 03 14 14 
03 03 03 03 03 03 03 08 08 03 08 08 03 08 08 08 08 08 08 08 08 03 03 14 14 
03 03 03 03 03 03 03 03 08 08 03 03 08 08 08 08 08 08 08 08 08 03 03 14 14 
03 03 03 03 03 03 03 03 08 08 03 08 08 08 08 08 08 08 08 08 08 08 03 14 14 
03 03 03 03 03 03 08 08 08 03 11 08 08 08 08 03 08 08 08 08 08 08 14 14 03 
03 03 03 03 08 08 08 03 08 08 03 08 08 08 03 03 03 08 08 08 08 14 14 14 03 
03 03 03 03 08 08 03 03 08 08 08 08 08 03 03 03 08 08 08 03 14 14 14 03 03 
03 03 08 08 08 03 08 08 08 08 08 08 08 08 03 18 08 08 08 03 14 14 03 03 03 
08 11 08 08 03 08 08 08 08 08 08 08 08 08 08 08 08 08 08 16 14 14 03 03 03 
03 03 08 03 03 08 08 08 08 03 08 08 08 08 03 08 08 12 08 08 14 14 03 03 03 
03 03 08 03 03 03 08 03 03 03 03 03 08 03 03 08 08 08 08 18 14 14 03 03 03 
03 08 08 08 03 03 03 08 03 03 03 08 08 03 03 03 03 03 08 03 03 14 14 03 03 
03 08 08 03 03 03 08 08 08 08 08 03 08 08 03 03 03 08 08 03 03 14 14 03 03 
03 08 08 03 03 08 08 08 08 08 08 03 08 08 08 08 03 08 08 03 03 14 14 03 03 
03 08 03 03 03 08 08 08 08 08 08 03 08 08 08 08 03 03 08 08 03 14 14 03 03 
03 08 03 03 03 03 08 08 08 03 03 03 08 08 08 03 03 03 08 08 03 14 14 03 03 
03 08 08 03 03 03 08 08 08 03 03 03 08 08 03 03 08 08 08 08 03 14 14 03 03 
03 08 03 08 08 08 08 08 08 03 03 03 08 08 08 08 08 08 08 08 14 14 14 03 03 
03 08 03 03 03 03 08 08 08 08 08 03 08 08 03 08 08 08 08 14 14 14 14 03 03 
19 08 03 03 03 03 03 08 08 08 08 08 08 08 03 03 08 08 08 08 14 14 14 14 03 
03 03 03 03 03 03 03 03 03 03 03 08 08 03 03 03 03 08 08 03 03 14 14 14 03 
03 03 03 03 03 03 03 03 03 03 03 03 03 03 03 03 03 03 20 03 03 14 14 14 03 
