03 03 03 03 03 03 03 03 03 03 03 03 03 03 03 03 03 03 20 03 03 14 14 14 03 
03 03 03 03 03 03 03 03 03 03 03 03 03 03 03 03 03 14 08 14 14 14 14 03 03 
03 03 03 03 03 03 03 03 03 03 03 03 03 03 03 03 03 14 08 14 14 14 14 14 03 
03 08 03 03 03 08 08 08 03 03 03 03 03 03 03 03 14 14 07 14 14 14 14 03 03 
19 08 08 03 03 03 08 08 08 03 03 03 03 03 03 03 14 14 07 14 14 03 03 03 03 
03 08 03 08 03 03 03 08 08 03 03 03 03 03 03 14 14 14 07 14 14 03 03 03 03 
03 08 08 08 03 08 08 08 08 08 08 03 03 03 03 03 14 14 07 14 14 03 03 03 03 
03 03 08 03 08 08 24 08 08 08 08 08 03 08 08 03 03 14 07 14 03 03 03 03 03 
03 03 08 08 03 08 08 08 08 08 08 08 08 08 08 08 03 03 08 03 03 03 03 03 03 
03 03 08 03 08 08 08 08 08 08 08 08 08 08 08 08 08 08 08 03 03 03 03 03 03 
03 08 08 03 08 08 08 08 08 08 08 03 08 03 03 08 08 03 08 03 03 03 03 03 03 
03 08 08 08 03 03 08 08 08 08 03 03 03 03 03 03 03 08 08 03 03 03 03 03 03 
03 03 08 08 03 03 03 08 08 03 03 03 03 03 03 03 03 08 08 03 08 03 03 03 03 
03 03 03 08 08 03 03 03 03 03 03 03 03 03 03 03 03 08 08 08 08 08 08 03 03 
03 03 03 08 08 03 03 03 03 03 03 03 03 03 03 03 03 03 08 08 08 08 08 08 03 
03 03 08 08 03 03 03 03 03 03 03 03 03 03 03 03 03 03 08 08 08 08 08 03 03 
03 08 08 03 03 03 14 03 03 03 03 03 03 03 03 03 03 08 08 03 03 08 08 08 03 
03 08 03 03 14 14 14 14 03 08 08 03 03 03 03 03 08 08 08 03 03 08 08 08 03 
03 08 08 14 14 14 14 14 08 08 08 08 08 08 03 08 08 08 03 03 08 08 03 03 03 
03 08 08 14 14 14 14 14 14 08 08 08 08 08 08 08 08 03 03 18 08 08 08 03 03 
03 03 08 07 07 07 07 07 07 08 08 08 08 08 08 08 03 03 03 03 08 03 03 03 03 
03 03 03 03 14 14 14 14 14 14 08 08 08 08 08 03 03 03 03 03 03 03 03 03 03 
03 03 03 03 03 14 14 14 14 08 08 08 03 03 03 03 03 03 03 03 03 03 03 03 03 
03 03 03 03 03 03 03 03 03 03 03 03 03 03 03 03 03 03 03 03 03 03 03 03 03 
03 03 03 03 03 03 03 03 03 03 03 03 03 03 03 03 03 03 03 03 03 03 03 03 03 
